Total final fixes: 72

Fixed administranto: changed paradigm 'a__adj' -> 'o__n' (agent noun), stem -> 'administrant'
Fixed adolecanto: changed paradigm 'a__adj' -> 'o__n' (agent noun), stem -> 'adolecant'
Fixed almonajo: changed paradigm 'a__adj' -> 'ajo__n' (concrete noun), stem -> 'almon'
Fixed aquafortajo: changed paradigm 'a__adj' -> 'ajo__n' (concrete noun), stem -> 'aquafort'
Fixed astonante: changed lemma to 'astonant' (present participle adjective), stem -> 'astonan'
Fixed bubacho: changed paradigm 'a__adj' -> 'o__n' (pejorative noun), stem -> 'bubach'
Fixed cedratajo: changed paradigm 'a__adj' -> 'ajo__n' (concrete noun), stem -> 'cedrat'
Fixed chambracho: changed paradigm 'a__adj' -> 'o__n' (pejorative noun), stem -> 'chambrach'
Fixed chasajo: changed paradigm 'a__adj' -> 'ajo__n' (concrete noun), stem -> 'chas'
Fixed civitaneso: changed paradigm 'a__adj' -> 'o__n' (quality noun), stem -> 'civitanes'
Fixed datumaro: changed paradigm 'a__adj' -> 'o__n' (collective noun), stem -> 'datumar'
Fixed debajo: changed paradigm 'a__adj' -> 'ajo__n' (concrete noun), stem -> 'deb'
Fixed demandanto: changed paradigm 'a__adj' -> 'o__n' (agent noun), stem -> 'demandant'
Fixed derivajo: changed paradigm 'a__adj' -> 'ajo__n' (concrete noun), stem -> 'deriv'
Fixed diletanto: changed paradigm 'a__adj' -> 'o__n' (agent noun), stem -> 'diletant'
Fixed domacho: changed paradigm 'a__adj' -> 'o__n' (pejorative noun), stem -> 'domach'
Fixed drinkajo: changed paradigm 'a__adj' -> 'ajo__n' (concrete noun), stem -> 'drink'
Fixed eskrokanto: changed paradigm 'a__adj' -> 'o__n' (agent noun), stem -> 'eskrokant'
Fixed furtanto: changed paradigm 'a__adj' -> 'o__n' (agent noun), stem -> 'furtant'
Fixed glaciajo: changed paradigm 'a__adj' -> 'ajo__n' (concrete noun), stem -> 'glaci'
Fixed habitantaro: changed paradigm 'a__adj' -> 'o__n' (collective noun), stem -> 'habitantar'
Fixed hararo: changed paradigm 'a__adj' -> 'o__n' (collective noun), stem -> 'harar'
Fixed instruktanto: changed paradigm 'a__adj' -> 'o__n' (agent noun), stem -> 'instruktant'
Fixed insularo: changed paradigm 'a__adj' -> 'o__n' (collective noun), stem -> 'insular'
Fixed jeranto: changed paradigm 'a__adj' -> 'o__n' (agent noun), stem -> 'jerant'
Fixed klavaro: changed paradigm 'a__adj' -> 'o__n' (collective noun), stem -> 'klavar'
Fixed koagulajo: changed paradigm 'a__adj' -> 'ajo__n' (concrete noun), stem -> 'koagul'
Fixed kolektajo: changed paradigm 'a__adj' -> 'ajo__n' (concrete noun), stem -> 'kolekt'
Fixed konfitajo: changed paradigm 'a__adj' -> 'ajo__n' (concrete noun), stem -> 'konfit'
Fixed konsumanto: changed paradigm 'a__adj' -> 'o__n' (agent noun), stem -> 'konsumant'
Fixed koruptajo: changed paradigm 'a__adj' -> 'ajo__n' (concrete noun), stem -> 'korupt'
Fixed krinaro: changed paradigm 'a__adj' -> 'o__n' (collective noun), stem -> 'krinar'
Fixed ludanto: changed paradigm 'a__adj' -> 'o__n' (agent noun), stem -> 'ludant'
Fixed materiajo: changed paradigm 'a__adj' -> 'ajo__n' (concrete noun), stem -> 'materi'
Fixed mesajacho: changed paradigm 'a__adj' -> 'o__n' (pejorative noun), stem -> 'mesajach'
Fixed moblaro: changed paradigm 'a__adj' -> 'o__n' (collective noun), stem -> 'moblar'
Fixed montaro: changed paradigm 'a__adj' -> 'o__n' (collective noun), stem -> 'montar'
Fixed nutrajo: changed paradigm 'a__adj' -> 'ajo__n' (concrete noun), stem -> 'nutr'
Fixed odianto: changed paradigm 'a__adj' -> 'o__n' (agent noun), stem -> 'odiant'
Fixed pasturajo: changed paradigm 'a__adj' -> 'ajo__n' (concrete noun), stem -> 'pastur'
Fixed peticionanto: changed paradigm 'a__adj' -> 'o__n' (agent noun), stem -> 'peticionant'
Fixed plumaro: changed paradigm 'a__adj' -> 'o__n' (collective noun), stem -> 'plumar'
Fixed preferajo: changed paradigm 'a__adj' -> 'ajo__n' (concrete noun), stem -> 'prefer'
Fixed projektajo: changed paradigm 'a__adj' -> 'ajo__n' (concrete noun), stem -> 'projekt'
Fixed proprietajo: changed paradigm 'a__adj' -> 'ajo__n' (concrete noun), stem -> 'propriet'
Fixed pueracho: changed paradigm 'a__adj' -> 'o__n' (pejorative noun), stem -> 'puerach'
Fixed requizitajo: changed paradigm 'a__adj' -> 'ajo__n' (concrete noun), stem -> 'requizit'
Fixed restajo: changed paradigm 'a__adj' -> 'ajo__n' (concrete noun), stem -> 'rest'
Fixed skribajo: changed paradigm 'a__adj' -> 'ajo__n' (concrete noun), stem -> 'skrib'
Fixed stelaro: changed paradigm 'a__adj' -> 'o__n' (collective noun), stem -> 'stelar'
Fixed subsidiajo: changed paradigm 'a__adj' -> 'ajo__n' (concrete noun), stem -> 'subsidi'
Fixed surveyanto: changed paradigm 'a__adj' -> 'o__n' (agent noun), stem -> 'surveyant'
Fixed terminaro: changed paradigm 'a__adj' -> 'o__n' (collective noun), stem -> 'terminar'
Fixed tradukanto: changed paradigm 'a__adj' -> 'o__n' (agent noun), stem -> 'tradukant'
Fixed urjanteso: changed paradigm 'a__adj' -> 'o__n' (quality noun), stem -> 'urjantes'
Fixed uzanto: changed paradigm 'a__adj' -> 'o__n' (agent noun), stem -> 'uzant'
Fixed vehanto: changed paradigm 'a__adj' -> 'o__n' (agent noun), stem -> 'vehant'
Fixed vejetanto: changed paradigm 'a__adj' -> 'o__n' (agent noun), stem -> 'vejetant'
Fixed vizitanto: changed paradigm 'a__adj' -> 'o__n' (agent noun), stem -> 'vizitant'
Fixed vortaro: changed paradigm 'a__adj' -> 'o__n' (collective noun), stem -> 'vortar'
Fixed bruneskar: changed paradigm 'e__adv' -> 'ar__vblex' (verb), stem -> 'brunesk'
Fixed chereskar: changed paradigm 'e__adv' -> 'ar__vblex' (verb), stem -> 'cheresk'
Fixed dormetar: changed paradigm 'e__adv' -> 'ar__vblex' (verb), stem -> 'dormet'
Fixed fatigeskar: changed paradigm 'e__adv' -> 'ar__vblex' (verb), stem -> 'fatigesk'
Fixed febleskar: changed paradigm 'e__adv' -> 'ar__vblex' (verb), stem -> 'feblesk'
Fixed konformeskar: changed paradigm 'e__adv' -> 'ar__vblex' (verb), stem -> 'konformesk'
Fixed ridetar: changed paradigm 'e__adv' -> 'ar__vblex' (verb), stem -> 'ridet'
Fixed saveskar: changed paradigm 'e__adv' -> 'ar__vblex' (verb), stem -> 'savesk'
Fixed situesar: changed paradigm 'e__adv' -> 'ar__vblex' (verb), stem -> 'situes'
Fixed somnolegar: changed paradigm 'e__adv' -> 'ar__vblex' (verb), stem -> 'somnoleg'
Fixed spliteskar: changed paradigm 'e__adv' -> 'ar__vblex' (verb), stem -> 'splitesk'
Fixed trovesar: changed paradigm 'e__adv' -> 'ar__vblex' (verb), stem -> 'troves'
