Total paradigm fixes: 1635

Fixed Kroniko: removed pipe from stem 'kronik|Kronik' -> 'Kronik' (proper noun)
Fixed Nombro: removed pipe from stem 'nombr|Nombr' -> 'Nombr' (proper noun)
Fixed Rejo: removed pipe from stem 'rej|Rej' -> 'Rej' (proper noun)
Fixed abatar: changed paradigm 'a__adj' -> 'ar__vblex', stem -> 'abat'
Fixed abdikar: changed paradigm 'a__adj' -> 'ar__vblex', stem -> 'abdik'
Fixed abolisar: changed paradigm 'a__adj' -> 'ar__vblex', stem -> 'abolis'
Fixed abominar: changed paradigm 'a__adj' -> 'ar__vblex', stem -> 'abomin'
Fixed abortar: changed paradigm 'a__adj' -> 'ar__vblex', stem -> 'abort'
Fixed abrogar: changed paradigm 'a__adj' -> 'ar__vblex', stem -> 'abrog'
Fixed absorbado: changed lemma to 'absorbada' (past participle), stem -> 'absorbad'
Fixed abstenar: changed paradigm 'a__adj' -> 'ar__vblex', stem -> 'absten'
Fixed abstinencar: changed paradigm 'a__adj' -> 'ar__vblex', stem -> 'abstinenc'
Fixed abundar: changed paradigm 'a__adj' -> 'ar__vblex', stem -> 'abund'
Fixed acelerar: changed paradigm 'a__adj' -> 'ar__vblex', stem -> 'aceler'
Fixed aceptar: changed paradigm 'a__adj' -> 'ar__vblex', stem -> 'acept'
Fixed adiar: changed paradigm 'a__adj' -> 'ar__vblex', stem -> 'adi'
Fixed adicionar: changed paradigm 'a__adj' -> 'ar__vblex', stem -> 'adicion'
Fixed admirar: changed paradigm 'a__adj' -> 'ar__vblex', stem -> 'admir'
Fixed adoptar: changed paradigm 'a__adj' -> 'ar__vblex', stem -> 'adopt'
Fixed adulterar: changed paradigm 'a__adj' -> 'ar__vblex', stem -> 'adulter'
Fixed afektacar: changed paradigm 'a__adj' -> 'ar__vblex', stem -> 'afektac'
Fixed afliktar: changed paradigm 'a__adj' -> 'ar__vblex', stem -> 'aflikt'
Fixed agnoskar: changed paradigm 'a__adj' -> 'ar__vblex', stem -> 'agnosk'
Fixed ajustar: changed paradigm 'a__adj' -> 'ar__vblex', stem -> 'ajust'
Fixed akrochar: changed paradigm 'a__adj' -> 'ar__vblex', stem -> 'akroch'
Fixed akuzar: changed paradigm 'a__adj' -> 'ar__vblex', stem -> 'akuz'
Fixed alterar: changed paradigm 'a__adj' -> 'ar__vblex', stem -> 'alter'
Fixed alternar: changed paradigm 'a__adj' -> 'ar__vblex', stem -> 'altern'
Fixed aludar: changed paradigm 'a__adj' -> 'ar__vblex', stem -> 'alud'
Fixed ameliorar: changed paradigm 'a__adj' -> 'ar__vblex', stem -> 'amelior'
Fixed amorar: changed paradigm 'a__adj' -> 'ar__vblex', stem -> 'amor'
Fixed amortisar: changed paradigm 'a__adj' -> 'ar__vblex', stem -> 'amortis'
Fixed amputar: changed paradigm 'a__adj' -> 'ar__vblex', stem -> 'amput'
Fixed amuzar: changed paradigm 'a__adj' -> 'ar__vblex', stem -> 'amuz'
Fixed analizar: changed paradigm 'a__adj' -> 'ar__vblex', stem -> 'analiz'
Fixed anexar: changed paradigm 'a__adj' -> 'ar__vblex', stem -> 'anex'
Fixed anhelar: changed paradigm 'a__adj' -> 'ar__vblex', stem -> 'anhel'
Fixed animar: changed paradigm 'a__adj' -> 'ar__vblex', stem -> 'anim'
Fixed anticipar: changed paradigm 'a__adj' -> 'ar__vblex', stem -> 'anticip'
Fixed anular: changed paradigm 'a__adj' -> 'ar__vblex', stem -> 'anul'
Fixed anuncar: changed paradigm 'a__adj' -> 'ar__vblex', stem -> 'anunc'
Fixed apartenar: changed paradigm 'a__adj' -> 'ar__vblex', stem -> 'aparten'
Fixed apelar: changed paradigm 'a__adj' -> 'ar__vblex', stem -> 'apel'
Fixed apertar: changed paradigm 'a__adj' -> 'ar__vblex', stem -> 'apert'
Fixed aplaudar: changed paradigm 'a__adj' -> 'ar__vblex', stem -> 'aplaud'
Fixed aplikar: changed paradigm 'a__adj' -> 'ar__vblex', stem -> 'aplik'
Fixed apogar: changed paradigm 'a__adj' -> 'ar__vblex', stem -> 'apog'
Fixed apreciar: changed paradigm 'a__adj' -> 'ar__vblex', stem -> 'apreci'
Fixed aprobar: changed paradigm 'a__adj' -> 'ar__vblex', stem -> 'aprob'
Fixed aquirar: changed paradigm 'a__adj' -> 'ar__vblex', stem -> 'aquir'
Fixed aranjar: changed paradigm 'a__adj' -> 'ar__vblex', stem -> 'aranj'
Fixed ardorar: changed paradigm 'a__adj' -> 'ar__vblex', stem -> 'ardor'
Fixed arestar: changed paradigm 'a__adj' -> 'ar__vblex', stem -> 'arest'
Fixed argumentar: changed paradigm 'a__adj' -> 'ar__vblex', stem -> 'argument'
Fixed arivar: changed paradigm 'a__adj' -> 'ar__vblex', stem -> 'ariv'
Fixed arozar: changed paradigm 'a__adj' -> 'ar__vblex', stem -> 'aroz'
Fixed artikular: changed paradigm 'a__adj' -> 'ar__vblex', stem -> 'artikul'
Fixed asekurar: changed paradigm 'a__adj' -> 'ar__vblex', stem -> 'asekur'
Fixed asertar: changed paradigm 'a__adj' -> 'ar__vblex', stem -> 'asert'
Fixed asignar: changed paradigm 'a__adj' -> 'ar__vblex', stem -> 'asign'
Fixed asimilar: changed paradigm 'a__adj' -> 'ar__vblex', stem -> 'asimil'
Fixed asistar: changed paradigm 'a__adj' -> 'ar__vblex', stem -> 'asist'
Fixed askoltar: changed paradigm 'a__adj' -> 'ar__vblex', stem -> 'askolt'
Fixed asociar: changed paradigm 'a__adj' -> 'ar__vblex', stem -> 'asoci'
Fixed aspektar: changed paradigm 'a__adj' -> 'ar__vblex', stem -> 'aspekt'
Fixed aspersar: changed paradigm 'a__adj' -> 'ar__vblex', stem -> 'aspers'
Fixed aspirar: changed paradigm 'a__adj' -> 'ar__vblex', stem -> 'aspir'
Fixed atachar: changed paradigm 'a__adj' -> 'ar__vblex', stem -> 'atach'
Fixed atakar: changed paradigm 'a__adj' -> 'ar__vblex', stem -> 'atak'
Fixed atentar: changed paradigm 'a__adj' -> 'ar__vblex', stem -> 'atent'
Fixed atestar: changed paradigm 'a__adj' -> 'ar__vblex', stem -> 'atest'
Fixed atingar: changed paradigm 'a__adj' -> 'ar__vblex', stem -> 'ating'
Fixed atraktar: changed paradigm 'a__adj' -> 'ar__vblex', stem -> 'atrakt'
Fixed atrapar: changed paradigm 'a__adj' -> 'ar__vblex', stem -> 'atrap'
Fixed atribuar: changed paradigm 'a__adj' -> 'ar__vblex', stem -> 'atribu'
Fixed audacar: changed paradigm 'a__adj' -> 'ar__vblex', stem -> 'audac'
Fixed audado: changed lemma to 'audada' (past participle), stem -> 'audad'
Fixed augurar: changed paradigm 'a__adj' -> 'ar__vblex', stem -> 'augur'
Fixed auskultar: changed paradigm 'a__adj' -> 'ar__vblex', stem -> 'auskult'
Fixed avancar: changed paradigm 'a__adj' -> 'ar__vblex', stem -> 'avanc'
Fixed avertar: changed paradigm 'a__adj' -> 'ar__vblex', stem -> 'avert'
Fixed aviacado: changed lemma to 'aviacada' (past participle), stem -> 'aviacad'
Fixed avizar: changed paradigm 'a__adj' -> 'ar__vblex', stem -> 'aviz'
Fixed babilar: changed paradigm 'a__adj' -> 'ar__vblex', stem -> 'babil'
Fixed bakar: changed paradigm 'a__adj' -> 'ar__vblex', stem -> 'bak'
Fixed balayar: changed paradigm 'a__adj' -> 'ar__vblex', stem -> 'balay'
Fixed balbutar: changed paradigm 'a__adj' -> 'ar__vblex', stem -> 'balbut'
Fixed balnar: changed paradigm 'a__adj' -> 'ar__vblex', stem -> 'baln'
Fixed bankrotar: changed paradigm 'a__adj' -> 'ar__vblex', stem -> 'bankrot'
Fixed baptar: changed paradigm 'a__adj' -> 'ar__vblex', stem -> 'bapt'
Fixed baraktar: changed paradigm 'a__adj' -> 'ar__vblex', stem -> 'barakt'
Fixed barar: changed paradigm 'a__adj' -> 'ar__vblex', stem -> 'bar'
Fixed bataliar: changed paradigm 'a__adj' -> 'ar__vblex', stem -> 'batali'
Fixed batar: changed paradigm 'a__adj' -> 'ar__vblex', stem -> 'bat'
Fixed bavar: changed paradigm 'a__adj' -> 'ar__vblex', stem -> 'bav'
Fixed benedikar: changed paradigm 'a__adj' -> 'ar__vblex', stem -> 'benedik'
Fixed bezonar: changed paradigm 'a__adj' -> 'ar__vblex', stem -> 'bezon'
Fixed bindar: changed paradigm 'a__adj' -> 'ar__vblex', stem -> 'bind'
Fixed blasfemar: changed paradigm 'a__adj' -> 'ar__vblex', stem -> 'blasfem'
Fixed blufar: changed paradigm 'a__adj' -> 'ar__vblex', stem -> 'bluf'
Fixed blutar: changed paradigm 'a__adj' -> 'ar__vblex', stem -> 'blut'
Fixed boikotar: changed paradigm 'a__adj' -> 'ar__vblex', stem -> 'boikot'
Fixed boliar: changed paradigm 'a__adj' -> 'ar__vblex', stem -> 'boli'
Fixed bombardar: changed paradigm 'a__adj' -> 'ar__vblex', stem -> 'bombard'
Fixed borar: changed paradigm 'a__adj' -> 'ar__vblex', stem -> 'bor'
Fixed boxar: changed paradigm 'a__adj' -> 'ar__vblex', stem -> 'box'
Fixed bramar: changed paradigm 'a__adj' -> 'ar__vblex', stem -> 'bram'
Fixed brandisar: changed paradigm 'a__adj' -> 'ar__vblex', stem -> 'brandis'
Fixed brasar: changed paradigm 'a__adj' -> 'ar__vblex', stem -> 'bras'
Fixed brazar: changed paradigm 'a__adj' -> 'ar__vblex', stem -> 'braz'
Fixed brodar: changed paradigm 'a__adj' -> 'ar__vblex', stem -> 'brod'
Fixed brodkastar: changed paradigm 'a__adj' -> 'ar__vblex', stem -> 'brodkast'
Fixed brosar: changed paradigm 'a__adj' -> 'ar__vblex', stem -> 'bros'
Fixed broshar: changed paradigm 'a__adj' -> 'ar__vblex', stem -> 'brosh'
Fixed bruisado: changed lemma to 'bruisada' (past participle), stem -> 'bruisad'
Fixed brular: changed paradigm 'a__adj' -> 'ar__vblex', stem -> 'brul'
Fixed buchar: changed paradigm 'a__adj' -> 'ar__vblex', stem -> 'buch'
Fixed budar: changed paradigm 'a__adj' -> 'ar__vblex', stem -> 'bud'
Fixed bugar: changed paradigm 'a__adj' -> 'ar__vblex', stem -> 'bug'
Fixed buklagar: changed paradigm 'a__adj' -> 'ar__vblex', stem -> 'buklag'
Fixed butar: changed paradigm 'a__adj' -> 'ar__vblex', stem -> 'but'
Fixed cedar: changed paradigm 'a__adj' -> 'ar__vblex', stem -> 'ced'
Fixed celebrar: changed paradigm 'a__adj' -> 'ar__vblex', stem -> 'celebr'
Fixed cementacar: changed paradigm 'a__adj' -> 'ar__vblex', stem -> 'cementac'
Fixed cementagar: changed paradigm 'a__adj' -> 'ar__vblex', stem -> 'cementag'
Fixed censurar: changed paradigm 'a__adj' -> 'ar__vblex', stem -> 'censur'
Fixed centripetar: changed paradigm 'a__adj' -> 'ar__vblex', stem -> 'centripet'
Fixed cernar: changed paradigm 'a__adj' -> 'ar__vblex', stem -> 'cern'
Fixed certifikar: changed paradigm 'a__adj' -> 'ar__vblex', stem -> 'certifik'
Fixed chanjar: changed paradigm 'a__adj' -> 'ar__vblex', stem -> 'chanj'
Fixed cherpar: changed paradigm 'a__adj' -> 'ar__vblex', stem -> 'cherp'
Fixed cinematografado: changed lemma to 'cinematografada' (past participle), stem -> 'cinematografad'
Fixed cirkoncizar: changed paradigm 'a__adj' -> 'ar__vblex', stem -> 'cirkonciz'
Fixed cirkular: changed paradigm 'a__adj' -> 'ar__vblex', stem -> 'cirkul'
Fixed damnar: changed paradigm 'a__adj' -> 'ar__vblex', stem -> 'damn'
Fixed dankar: changed paradigm 'a__adj' -> 'ar__vblex', stem -> 'dank'
Fixed dansar: changed paradigm 'a__adj' -> 'ar__vblex', stem -> 'dans'
Fixed darfar: changed paradigm 'a__adj' -> 'ar__vblex', stem -> 'darf'
Fixed darnar: changed paradigm 'a__adj' -> 'ar__vblex', stem -> 'darn'
Fixed dazlar: changed paradigm 'a__adj' -> 'ar__vblex', stem -> 'dazl'
Fixed debatar: changed paradigm 'a__adj' -> 'ar__vblex', stem -> 'debat'
Fixed debutar: changed paradigm 'a__adj' -> 'ar__vblex', stem -> 'debut'
Fixed decar: changed paradigm 'a__adj' -> 'ar__vblex', stem -> 'dec'
Fixed decensar: changed paradigm 'a__adj' -> 'ar__vblex', stem -> 'decens'
Fixed deceptar: changed paradigm 'a__adj' -> 'ar__vblex', stem -> 'decept'
Fixed dechifrar: changed paradigm 'a__adj' -> 'ar__vblex', stem -> 'dechifr'
Fixed decidar: changed paradigm 'a__adj' -> 'ar__vblex', stem -> 'decid'
Fixed dedikar: changed paradigm 'a__adj' -> 'ar__vblex', stem -> 'dedik'
Fixed deduktar: changed paradigm 'a__adj' -> 'ar__vblex', stem -> 'dedukt'
Fixed defensar: changed paradigm 'a__adj' -> 'ar__vblex', stem -> 'defens'
Fixed defiar: changed paradigm 'a__adj' -> 'ar__vblex', stem -> 'defi'
Fixed defilar: changed paradigm 'a__adj' -> 'ar__vblex', stem -> 'defil'
Fixed definar: changed paradigm 'a__adj' -> 'ar__vblex', stem -> 'defin'
Fixed deformar: changed paradigm 'a__adj' -> 'ar__vblex', stem -> 'deform'
Fixed degenerar: changed paradigm 'a__adj' -> 'ar__vblex', stem -> 'degener'
Fixed degnar: changed paradigm 'a__adj' -> 'ar__vblex', stem -> 'degn'
Fixed degradar: changed paradigm 'a__adj' -> 'ar__vblex', stem -> 'degrad'
Fixed dejunar: changed paradigm 'a__adj' -> 'ar__vblex', stem -> 'dejun'
Fixed dejurar: changed paradigm 'a__adj' -> 'ar__vblex', stem -> 'dejur'
Fixed dekadar: changed paradigm 'a__adj' -> 'ar__vblex', stem -> 'dekad'
Fixed dekantar: changed paradigm 'a__adj' -> 'ar__vblex', stem -> 'dekant'
Fixed deklarar: changed paradigm 'a__adj' -> 'ar__vblex', stem -> 'deklar'
Fixed deklinado: changed lemma to 'deklinada' (past participle), stem -> 'deklinad'
Fixed dekoktar: changed paradigm 'a__adj' -> 'ar__vblex', stem -> 'dekokt'
Fixed dekoltar: changed paradigm 'a__adj' -> 'ar__vblex', stem -> 'dekolt'
Fixed dekorar: changed paradigm 'a__adj' -> 'ar__vblex', stem -> 'dekor'
Fixed delegar: changed paradigm 'a__adj' -> 'ar__vblex', stem -> 'deleg'
Fixed delektar: changed paradigm 'a__adj' -> 'ar__vblex', stem -> 'delekt'
Fixed deliberar: changed paradigm 'a__adj' -> 'ar__vblex', stem -> 'deliber'
Fixed deliktar: changed paradigm 'a__adj' -> 'ar__vblex', stem -> 'delikt'
Fixed delirar: changed paradigm 'a__adj' -> 'ar__vblex', stem -> 'delir'
Fixed demarshar: changed paradigm 'a__adj' -> 'ar__vblex', stem -> 'demarsh'
Fixed dementiar: changed paradigm 'a__adj' -> 'ar__vblex', stem -> 'dementi'
Fixed demisionar: changed paradigm 'a__adj' -> 'ar__vblex', stem -> 'demision'
Fixed demolisar: changed paradigm 'a__adj' -> 'ar__vblex', stem -> 'demolis'
Fixed demonstrar: changed paradigm 'a__adj' -> 'ar__vblex', stem -> 'demonstr'
Fixed denaturar: changed paradigm 'a__adj' -> 'ar__vblex', stem -> 'denatur'
Fixed denigrar: changed paradigm 'a__adj' -> 'ar__vblex', stem -> 'denigr'
Fixed denuncar: changed paradigm 'a__adj' -> 'ar__vblex', stem -> 'denunc'
Fixed departar: changed paradigm 'a__adj' -> 'ar__vblex', stem -> 'depart'
Fixed dependar: changed paradigm 'a__adj' -> 'ar__vblex', stem -> 'depend'
Fixed deportar: changed paradigm 'a__adj' -> 'ar__vblex', stem -> 'deport'
Fixed depozar: changed paradigm 'a__adj' -> 'ar__vblex', stem -> 'depoz'
Fixed depresar: changed paradigm 'a__adj' -> 'ar__vblex', stem -> 'depres'
Fixed deputar: changed paradigm 'a__adj' -> 'ar__vblex', stem -> 'deput'
Fixed desegnar: changed paradigm 'a__adj' -> 'ar__vblex', stem -> 'desegn'
Fixed desertar: changed paradigm 'a__adj' -> 'ar__vblex', stem -> 'desert'
Fixed deskriptado: changed lemma to 'deskriptada' (past participle), stem -> 'deskriptad'
Fixed destinar: changed paradigm 'a__adj' -> 'ar__vblex', stem -> 'destin'
Fixed destruktar: changed paradigm 'a__adj' -> 'ar__vblex', stem -> 'destrukt'
Fixed determinar: changed paradigm 'a__adj' -> 'ar__vblex', stem -> 'determin'
Fixed detersar: changed paradigm 'a__adj' -> 'ar__vblex', stem -> 'deters'
Fixed detrimentar: changed paradigm 'a__adj' -> 'ar__vblex', stem -> 'detriment'
Fixed devancar: changed paradigm 'a__adj' -> 'ar__vblex', stem -> 'devanc'
Fixed devar: changed paradigm 'a__adj' -> 'ar__vblex', stem -> 'dev'
Fixed developar: changed paradigm 'a__adj' -> 'ar__vblex', stem -> 'develop'
Fixed deviacar: changed paradigm 'a__adj' -> 'ar__vblex', stem -> 'deviac'
Fixed dezirar: changed paradigm 'a__adj' -> 'ar__vblex', stem -> 'dezir'
Fixed dezolar: changed paradigm 'a__adj' -> 'ar__vblex', stem -> 'dezol'
Fixed diagnozar: changed paradigm 'a__adj' -> 'ar__vblex', stem -> 'diagnoz'
Fixed dicar: changed paradigm 'a__adj' -> 'ar__vblex', stem -> 'dic'
Fixed dicernar: changed paradigm 'a__adj' -> 'ar__vblex', stem -> 'dicern'
Fixed diciplinar: changed paradigm 'a__adj' -> 'ar__vblex', stem -> 'diciplin'
Fixed difamado: changed lemma to 'difamada' (past participle), stem -> 'difamad'
Fixed diferar: changed paradigm 'a__adj' -> 'ar__vblex', stem -> 'difer'
Fixed difuzar: changed paradigm 'a__adj' -> 'ar__vblex', stem -> 'difuz'
Fixed digestar: changed paradigm 'a__adj' -> 'ar__vblex', stem -> 'digest'
Fixed digresar: changed paradigm 'a__adj' -> 'ar__vblex', stem -> 'digres'
Fixed diktar: changed paradigm 'a__adj' -> 'ar__vblex', stem -> 'dikt'
Fixed dilatar: changed paradigm 'a__adj' -> 'ar__vblex', stem -> 'dilat'
Fixed dilutar: changed paradigm 'a__adj' -> 'ar__vblex', stem -> 'dilut'
Fixed diminutar: changed paradigm 'a__adj' -> 'ar__vblex', stem -> 'diminut'
Fixed dinear: changed paradigm 'a__adj' -> 'ar__vblex', stem -> 'dine'
Fixed direktar: changed paradigm 'a__adj' -> 'ar__vblex', stem -> 'direkt'
Fixed disertar: changed paradigm 'a__adj' -> 'ar__vblex', stem -> 'disert'
Fixed disipar: changed paradigm 'a__adj' -> 'ar__vblex', stem -> 'disip'
Fixed diskontar: changed paradigm 'a__adj' -> 'ar__vblex', stem -> 'diskont'
Fixed diskriminacar: changed paradigm 'a__adj' -> 'ar__vblex', stem -> 'diskriminac'
Fixed diskursar: changed paradigm 'a__adj' -> 'ar__vblex', stem -> 'diskurs'
Fixed diskutar: changed paradigm 'a__adj' -> 'ar__vblex', stem -> 'diskut'
Fixed disociar: changed paradigm 'a__adj' -> 'ar__vblex', stem -> 'disoci'
Fixed dispersar: changed paradigm 'a__adj' -> 'ar__vblex', stem -> 'dispers'
Fixed disponar: changed paradigm 'a__adj' -> 'ar__vblex', stem -> 'dispon'
Fixed disputar: changed paradigm 'a__adj' -> 'ar__vblex', stem -> 'disput'
Fixed distilar: changed paradigm 'a__adj' -> 'ar__vblex', stem -> 'distil'
Fixed distingar: changed paradigm 'a__adj' -> 'ar__vblex', stem -> 'disting'
Fixed distraktar: changed paradigm 'a__adj' -> 'ar__vblex', stem -> 'distrakt'
Fixed distributar: changed paradigm 'a__adj' -> 'ar__vblex', stem -> 'distribut'
Fixed ditenar: changed paradigm 'a__adj' -> 'ar__vblex', stem -> 'diten'
Fixed divenar: changed paradigm 'a__adj' -> 'ar__vblex', stem -> 'diven'
Fixed divergar: changed paradigm 'a__adj' -> 'ar__vblex', stem -> 'diverg'
Fixed dividar: changed paradigm 'a__adj' -> 'ar__vblex', stem -> 'divid'
Fixed divinar: changed paradigm 'a__adj' -> 'ar__vblex', stem -> 'divin'
Fixed divulgar: changed paradigm 'a__adj' -> 'ar__vblex', stem -> 'divulg'
Fixed docar: changed paradigm 'a__adj' -> 'ar__vblex', stem -> 'doc'
Fixed dolorar: changed paradigm 'a__adj' -> 'ar__vblex', stem -> 'dolor'
Fixed domajar: changed paradigm 'a__adj' -> 'ar__vblex', stem -> 'domaj'
Fixed dominacar: changed paradigm 'a__adj' -> 'ar__vblex', stem -> 'dominac'
Fixed domtar: changed paradigm 'a__adj' -> 'ar__vblex', stem -> 'domt'
Fixed donacar: changed paradigm 'a__adj' -> 'ar__vblex', stem -> 'donac'
Fixed donar: changed paradigm 'a__adj' -> 'ar__vblex', stem -> 'don'
Fixed dorlotar: changed paradigm 'a__adj' -> 'ar__vblex', stem -> 'dorlot'
Fixed dormar: changed paradigm 'a__adj' -> 'ar__vblex', stem -> 'dorm'
Fixed dotar: changed paradigm 'a__adj' -> 'ar__vblex', stem -> 'dot'
Fixed dragar: changed paradigm 'a__adj' -> 'ar__vblex', stem -> 'drag'
Fixed drapirar: changed paradigm 'a__adj' -> 'ar__vblex', stem -> 'drapir'
Fixed drashar: changed paradigm 'a__adj' -> 'ar__vblex', stem -> 'drash'
Fixed drenar: changed paradigm 'a__adj' -> 'ar__vblex', stem -> 'dren'
Fixed dresar: changed paradigm 'a__adj' -> 'ar__vblex', stem -> 'dres'
Fixed driftar: changed paradigm 'a__adj' -> 'ar__vblex', stem -> 'drift'
Fixed dronar: changed paradigm 'a__adj' -> 'ar__vblex', stem -> 'dron'
Fixed dubitar: changed paradigm 'a__adj' -> 'ar__vblex', stem -> 'dubit'
Fixed duktar: changed paradigm 'a__adj' -> 'ar__vblex', stem -> 'dukt'
Fixed durado: changed lemma to 'durada' (past participle), stem -> 'durad'
Fixed durstar: changed paradigm 'a__adj' -> 'ar__vblex', stem -> 'durst'
Fixed dushar: changed paradigm 'a__adj' -> 'ar__vblex', stem -> 'dush'
Fixed ebuliar: changed paradigm 'a__adj' -> 'ar__vblex', stem -> 'ebuli'
Fixed eceptar: changed paradigm 'a__adj' -> 'ar__vblex', stem -> 'ecept'
Fixed ecesar: changed paradigm 'a__adj' -> 'ar__vblex', stem -> 'eces'
Fixed ecitar: changed paradigm 'a__adj' -> 'ar__vblex', stem -> 'ecit'
Fixed edifikar: changed paradigm 'a__adj' -> 'ar__vblex', stem -> 'edifik'
Fixed ediktar: changed paradigm 'a__adj' -> 'ar__vblex', stem -> 'edikt'
Fixed editar: changed paradigm 'a__adj' -> 'ar__vblex', stem -> 'edit'
Fixed edukado: changed lemma to 'edukada' (past participle), stem -> 'edukad'
Fixed efacar: changed paradigm 'a__adj' -> 'ar__vblex', stem -> 'efac'
Fixed efikar: changed paradigm 'a__adj' -> 'ar__vblex', stem -> 'efik'
Fixed egarar: changed paradigm 'a__adj' -> 'ar__vblex', stem -> 'egar'
Fixed egardar: changed paradigm 'a__adj' -> 'ar__vblex', stem -> 'egard'
Fixed ejektar: changed paradigm 'a__adj' -> 'ar__vblex', stem -> 'ejekt'
Fixed eklipsar: changed paradigm 'a__adj' -> 'ar__vblex', stem -> 'eklips'
Fixed elaborar: changed paradigm 'a__adj' -> 'ar__vblex', stem -> 'elabor'
Fixed elektado: changed lemma to 'elektada' (past participle), stem -> 'elektad'
Fixed elevar: changed paradigm 'a__adj' -> 'ar__vblex', stem -> 'elev'
Fixed eliminar: changed paradigm 'a__adj' -> 'ar__vblex', stem -> 'elimin'
Fixed elizionar: changed paradigm 'a__adj' -> 'ar__vblex', stem -> 'elizion'
Fixed eludar: changed paradigm 'a__adj' -> 'ar__vblex', stem -> 'elud'
Fixed emanar: changed paradigm 'a__adj' -> 'ar__vblex', stem -> 'eman'
Fixed emancipar: changed paradigm 'a__adj' -> 'ar__vblex', stem -> 'emancip'
Fixed embarasar: changed paradigm 'a__adj' -> 'ar__vblex', stem -> 'embaras'
Fixed embargar: changed paradigm 'a__adj' -> 'ar__vblex', stem -> 'embarg'
Fixed embarkar: changed paradigm 'a__adj' -> 'ar__vblex', stem -> 'embark'
Fixed embracar: changed paradigm 'a__adj' -> 'ar__vblex', stem -> 'embrac'
Fixed embragar: changed paradigm 'a__adj' -> 'ar__vblex', stem -> 'embrag'
Fixed embuskar: changed paradigm 'a__adj' -> 'ar__vblex', stem -> 'embusk'
Fixed emendar: changed paradigm 'a__adj' -> 'ar__vblex', stem -> 'emend'
Fixed emersar: changed paradigm 'a__adj' -> 'ar__vblex', stem -> 'emers'
Fixed emfazar: changed paradigm 'a__adj' -> 'ar__vblex', stem -> 'emfaz'
Fixed emisar: changed paradigm 'a__adj' -> 'ar__vblex', stem -> 'emis'
Fixed employar: changed paradigm 'a__adj' -> 'ar__vblex', stem -> 'employ'
Fixed emulsar: changed paradigm 'a__adj' -> 'ar__vblex', stem -> 'emuls'
Fixed emundar: changed paradigm 'a__adj' -> 'ar__vblex', stem -> 'emund'
Fixed engajar: changed paradigm 'a__adj' -> 'ar__vblex', stem -> 'engaj'
Fixed enoyar: changed paradigm 'a__adj' -> 'ar__vblex', stem -> 'enoy'
Fixed enternar: changed paradigm 'a__adj' -> 'ar__vblex', stem -> 'entern'
Fixed entraprezar: changed paradigm 'a__adj' -> 'ar__vblex', stem -> 'entraprez'
Fixed entratenar: changed paradigm 'a__adj' -> 'ar__vblex', stem -> 'entraten'
Fixed entravar: changed paradigm 'a__adj' -> 'ar__vblex', stem -> 'entrav'
Fixed entrenar: changed paradigm 'a__adj' -> 'ar__vblex', stem -> 'entren'
Fixed entuziasmar: changed paradigm 'a__adj' -> 'ar__vblex', stem -> 'entuziasm'
Fixed enumerar: changed paradigm 'a__adj' -> 'ar__vblex', stem -> 'enumer'
Fixed enuncar: changed paradigm 'a__adj' -> 'ar__vblex', stem -> 'enunc'
Fixed envelopar: changed paradigm 'a__adj' -> 'ar__vblex', stem -> 'envelop'
Fixed envidiar: changed paradigm 'a__adj' -> 'ar__vblex', stem -> 'envidi'
Fixed equilibrar: changed paradigm 'a__adj' -> 'ar__vblex', stem -> 'equilibr'
Fixed equipado: changed lemma to 'equipada' (past participle), stem -> 'equipad'
Fixed erektar: changed paradigm 'a__adj' -> 'ar__vblex', stem -> 'erekt'
Fixed erodar: changed paradigm 'a__adj' -> 'ar__vblex', stem -> 'erod'
Fixed erorar: changed paradigm 'a__adj' -> 'ar__vblex', stem -> 'eror'
Fixed erudar: changed paradigm 'a__adj' -> 'ar__vblex', stem -> 'erud'
Fixed eruptar: changed paradigm 'a__adj' -> 'ar__vblex', stem -> 'erupt'
Fixed esbosar: changed paradigm 'a__adj' -> 'ar__vblex', stem -> 'esbos'
Fixed esforcar: changed paradigm 'a__adj' -> 'ar__vblex', stem -> 'esforc'
Fixed eskaldar: changed paradigm 'a__adj' -> 'ar__vblex', stem -> 'eskald'
Fixed eskapar: changed paradigm 'a__adj' -> 'ar__vblex', stem -> 'eskap'
Fixed eskartar: changed paradigm 'a__adj' -> 'ar__vblex', stem -> 'eskart'
Fixed espelar: changed paradigm 'a__adj' -> 'ar__vblex', stem -> 'espel'
Fixed esperar: changed paradigm 'a__adj' -> 'ar__vblex', stem -> 'esper'
Fixed establisar: changed paradigm 'a__adj' -> 'ar__vblex', stem -> 'establis'
Fixed estalar: changed paradigm 'a__adj' -> 'ar__vblex', stem -> 'estal'
Fixed estampar: changed paradigm 'a__adj' -> 'ar__vblex', stem -> 'estamp'
Fixed estanchar: changed paradigm 'a__adj' -> 'ar__vblex', stem -> 'estanch'
Fixed estimar: changed paradigm 'a__adj' -> 'ar__vblex', stem -> 'estim'
Fixed estompar: changed paradigm 'a__adj' -> 'ar__vblex', stem -> 'estomp'
Fixed esvanar: changed paradigm 'a__adj' -> 'ar__vblex', stem -> 'esvan'
Fixed etapar: changed paradigm 'a__adj' -> 'ar__vblex', stem -> 'etap'
Fixed evakuar: changed paradigm 'a__adj' -> 'ar__vblex', stem -> 'evaku'
Fixed evaluado: changed lemma to 'evaluada' (past participle), stem -> 'evaluad'
Fixed evar: changed paradigm 'a__adj' -> 'ar__vblex', stem -> 'ev'
Fixed eventar: changed paradigm 'a__adj' -> 'ar__vblex', stem -> 'event'
Fixed evitar: changed paradigm 'a__adj' -> 'ar__vblex', stem -> 'evit'
Fixed evolucionar: changed paradigm 'a__adj' -> 'ar__vblex', stem -> 'evolucion'
Fixed exajerar: changed paradigm 'a__adj' -> 'ar__vblex', stem -> 'exajer'
Fixed exaltar: changed paradigm 'a__adj' -> 'ar__vblex', stem -> 'exalt'
Fixed examenar: changed paradigm 'a__adj' -> 'ar__vblex', stem -> 'examen'
Fixed exasperar: changed paradigm 'a__adj' -> 'ar__vblex', stem -> 'exasper'
Fixed exekutar: changed paradigm 'a__adj' -> 'ar__vblex', stem -> 'exekut'
Fixed exercar: changed paradigm 'a__adj' -> 'ar__vblex', stem -> 'exerc'
Fixed exfoliar: changed paradigm 'a__adj' -> 'ar__vblex', stem -> 'exfoli'
Fixed exhalar: changed paradigm 'a__adj' -> 'ar__vblex', stem -> 'exhal'
Fixed exhaustar: changed paradigm 'a__adj' -> 'ar__vblex', stem -> 'exhaust'
Fixed exhortar: changed paradigm 'a__adj' -> 'ar__vblex', stem -> 'exhort'
Fixed exilar: changed paradigm 'a__adj' -> 'ar__vblex', stem -> 'exil'
Fixed existar: changed paradigm 'a__adj' -> 'ar__vblex', stem -> 'exist'
Fixed exkavar: changed paradigm 'a__adj' -> 'ar__vblex', stem -> 'exkav'
Fixed exkluzar: changed paradigm 'a__adj' -> 'ar__vblex', stem -> 'exkluz'
Fixed exkomunikar: changed paradigm 'a__adj' -> 'ar__vblex', stem -> 'exkomunik'
Fixed exkoriar: changed paradigm 'a__adj' -> 'ar__vblex', stem -> 'exkori'
Fixed exkursar: changed paradigm 'a__adj' -> 'ar__vblex', stem -> 'exkurs'
Fixed exkuzar: changed paradigm 'a__adj' -> 'ar__vblex', stem -> 'exkuz'
Fixed exorcisar: changed paradigm 'a__adj' -> 'ar__vblex', stem -> 'exorcis'
Fixed expansar: changed paradigm 'a__adj' -> 'ar__vblex', stem -> 'expans'
Fixed expediar: changed paradigm 'a__adj' -> 'ar__vblex', stem -> 'expedi'
Fixed expektar: changed paradigm 'a__adj' -> 'ar__vblex', stem -> 'expekt'
Fixed experiencar: changed paradigm 'a__adj' -> 'ar__vblex', stem -> 'experienc'
Fixed experimentar: changed paradigm 'a__adj' -> 'ar__vblex', stem -> 'experiment'
Fixed expirar: changed paradigm 'a__adj' -> 'ar__vblex', stem -> 'expir'
Fixed explikar: changed paradigm 'a__adj' -> 'ar__vblex', stem -> 'explik'
Fixed explorar: changed paradigm 'a__adj' -> 'ar__vblex', stem -> 'explor'
Fixed explotar: changed paradigm 'a__adj' -> 'ar__vblex', stem -> 'explot'
Fixed explozar: changed paradigm 'a__adj' -> 'ar__vblex', stem -> 'exploz'
Fixed exportacar: changed paradigm 'a__adj' -> 'ar__vblex', stem -> 'exportac'
Fixed expozar: changed paradigm 'a__adj' -> 'ar__vblex', stem -> 'expoz'
Fixed expresar: changed paradigm 'a__adj' -> 'ar__vblex', stem -> 'expres'
Fixed extazar: changed paradigm 'a__adj' -> 'ar__vblex', stem -> 'extaz'
Fixed extensar: changed paradigm 'a__adj' -> 'ar__vblex', stem -> 'extens'
Fixed exterminar: changed paradigm 'a__adj' -> 'ar__vblex', stem -> 'extermin'
Fixed extingar: changed paradigm 'a__adj' -> 'ar__vblex', stem -> 'exting'
Fixed extirpar: changed paradigm 'a__adj' -> 'ar__vblex', stem -> 'extirp'
Fixed extorsado: changed lemma to 'extorsada' (past participle), stem -> 'extorsad'
Fixed extraktar: changed paradigm 'a__adj' -> 'ar__vblex', stem -> 'extrakt'
Fixed exudar: changed paradigm 'a__adj' -> 'ar__vblex', stem -> 'exud'
Fixed fabrikar: changed paradigm 'a__adj' -> 'ar__vblex', stem -> 'fabrik'
Fixed facar: changed paradigm 'a__adj' -> 'ar__vblex', stem -> 'fac'
Fixed facinar: changed paradigm 'a__adj' -> 'ar__vblex', stem -> 'facin'
Fixed facionar: changed paradigm 'a__adj' -> 'ar__vblex', stem -> 'facion'
Fixed falar: changed paradigm 'a__adj' -> 'ar__vblex', stem -> 'fal'
Fixed falchar: changed paradigm 'a__adj' -> 'ar__vblex', stem -> 'falch'
Fixed faldar: changed paradigm 'a__adj' -> 'ar__vblex', stem -> 'fald'
Fixed faliar: changed paradigm 'a__adj' -> 'ar__vblex', stem -> 'fali'
Fixed fanar: changed paradigm 'a__adj' -> 'ar__vblex', stem -> 'fan'
Fixed fanfaronar: changed paradigm 'a__adj' -> 'ar__vblex', stem -> 'fanfaron'
Fixed fantaziar: changed paradigm 'a__adj' -> 'ar__vblex', stem -> 'fantazi'
Fixed farmar: changed paradigm 'a__adj' -> 'ar__vblex', stem -> 'farm'
Fixed fasonado: changed lemma to 'fasonada' (past participle), stem -> 'fasonad'
Fixed fastar: changed paradigm 'a__adj' -> 'ar__vblex', stem -> 'fast'
Fixed fatigar: changed paradigm 'a__adj' -> 'ar__vblex', stem -> 'fatig'
Fixed favorar: changed paradigm 'a__adj' -> 'ar__vblex', stem -> 'favor'
Fixed federar: changed paradigm 'a__adj' -> 'ar__vblex', stem -> 'feder'
Fixed felaciar: changed paradigm 'a__adj' -> 'ar__vblex', stem -> 'felaci'
Fixed fendar: changed paradigm 'a__adj' -> 'ar__vblex', stem -> 'fend'
Fixed fermentacado: changed lemma to 'fermentacada' (past participle), stem -> 'fermentacad'
Fixed fervorar: changed paradigm 'a__adj' -> 'ar__vblex', stem -> 'fervor'
Fixed festado: changed lemma to 'festada' (past participle), stem -> 'festad'
Fixed festinar: changed paradigm 'a__adj' -> 'ar__vblex', stem -> 'festin'
Fixed fiancar: changed paradigm 'a__adj' -> 'ar__vblex', stem -> 'fianc'
Fixed fidar: changed paradigm 'a__adj' -> 'ar__vblex', stem -> 'fid'
Fixed filozofiar: changed paradigm 'a__adj' -> 'ar__vblex', stem -> 'filozofi'
Fixed filtrar: changed paradigm 'a__adj' -> 'ar__vblex', stem -> 'filtr'
Fixed fingar: changed paradigm 'a__adj' -> 'ar__vblex', stem -> 'fing'
Fixed finisar: changed paradigm 'a__adj' -> 'ar__vblex', stem -> 'finis'
Fixed fitar: changed paradigm 'a__adj' -> 'ar__vblex', stem -> 'fit'
Fixed flagrar: changed paradigm 'a__adj' -> 'ar__vblex', stem -> 'flagr'
Fixed flarar: changed paradigm 'a__adj' -> 'ar__vblex', stem -> 'flar'
Fixed flatar: changed paradigm 'a__adj' -> 'ar__vblex', stem -> 'flat'
Fixed flatuar: changed paradigm 'a__adj' -> 'ar__vblex', stem -> 'flatu'
Fixed flegar: changed paradigm 'a__adj' -> 'ar__vblex', stem -> 'fleg'
Fixed flexar: changed paradigm 'a__adj' -> 'ar__vblex', stem -> 'flex'
Fixed flirtar: changed paradigm 'a__adj' -> 'ar__vblex', stem -> 'flirt'
Fixed flogar: changed paradigm 'a__adj' -> 'ar__vblex', stem -> 'flog'
Fixed flotacar: changed paradigm 'a__adj' -> 'ar__vblex', stem -> 'flotac'
Fixed flugar: changed paradigm 'a__adj' -> 'ar__vblex', stem -> 'flug'
Fixed fluktuar: changed paradigm 'a__adj' -> 'ar__vblex', stem -> 'fluktu'
Fixed fluorecar: changed paradigm 'a__adj' -> 'ar__vblex', stem -> 'fluorec'
Fixed fomentar: changed paradigm 'a__adj' -> 'ar__vblex', stem -> 'foment'
Fixed fondar: changed paradigm 'a__adj' -> 'ar__vblex', stem -> 'fond'
Fixed fonografar: changed paradigm 'a__adj' -> 'ar__vblex', stem -> 'fonograf'
Fixed forjar: changed paradigm 'a__adj' -> 'ar__vblex', stem -> 'forj'
Fixed formacar: changed paradigm 'a__adj' -> 'ar__vblex', stem -> 'formac'
Fixed fosforecar: changed paradigm 'a__adj' -> 'ar__vblex', stem -> 'fosforec'
Fixed fotografar: changed paradigm 'a__adj' -> 'ar__vblex', stem -> 'fotograf'
Fixed fotokopiar: changed paradigm 'a__adj' -> 'ar__vblex', stem -> 'fotokopi'
Fixed frakasar: changed paradigm 'a__adj' -> 'ar__vblex', stem -> 'frakas'
Fixed frapar: changed paradigm 'a__adj' -> 'ar__vblex', stem -> 'frap'
Fixed fraudar: changed paradigm 'a__adj' -> 'ar__vblex', stem -> 'fraud'
Fixed fremisar: changed paradigm 'a__adj' -> 'ar__vblex', stem -> 'fremis'
Fixed frequentar: changed paradigm 'a__adj' -> 'ar__vblex', stem -> 'frequent'
Fixed fretar: changed paradigm 'a__adj' -> 'ar__vblex', stem -> 'fret'
Fixed fricionar: changed paradigm 'a__adj' -> 'ar__vblex', stem -> 'fricion'
Fixed friskar: changed paradigm 'a__adj' -> 'ar__vblex', stem -> 'frisk'
Fixed fritado: changed lemma to 'fritada' (past participle), stem -> 'fritad'
Fixed frizar: changed paradigm 'a__adj' -> 'ar__vblex', stem -> 'friz'
Fixed frostar: changed paradigm 'a__adj' -> 'ar__vblex', stem -> 'frost'
Fixed frotar: changed paradigm 'a__adj' -> 'ar__vblex', stem -> 'frot'
Fixed frunsar: changed paradigm 'a__adj' -> 'ar__vblex', stem -> 'fruns'
Fixed frustrar: changed paradigm 'a__adj' -> 'ar__vblex', stem -> 'frustr'
Fixed fugar: changed paradigm 'a__adj' -> 'ar__vblex', stem -> 'fug'
Fixed fular: changed paradigm 'a__adj' -> 'ar__vblex', stem -> 'ful'
Fixed fulminar: changed paradigm 'a__adj' -> 'ar__vblex', stem -> 'fulmin'
Fixed fumar: changed paradigm 'a__adj' -> 'ar__vblex', stem -> 'fum'
Fixed funcionar: changed paradigm 'a__adj' -> 'ar__vblex', stem -> 'funcion'
Fixed furnisar: changed paradigm 'a__adj' -> 'ar__vblex', stem -> 'furnis'
Fixed fushar: changed paradigm 'a__adj' -> 'ar__vblex', stem -> 'fush'
Fixed futuar: changed paradigm 'a__adj' -> 'ar__vblex', stem -> 'futu'
Fixed fuzar: changed paradigm 'a__adj' -> 'ar__vblex', stem -> 'fuz'
Fixed galopar: changed paradigm 'a__adj' -> 'ar__vblex', stem -> 'galop'
Fixed gambitar: changed paradigm 'a__adj' -> 'ar__vblex', stem -> 'gambit'
Fixed gambolar: changed paradigm 'a__adj' -> 'ar__vblex', stem -> 'gambol'
Fixed ganar: changed paradigm 'a__adj' -> 'ar__vblex', stem -> 'gan'
Fixed gapar: changed paradigm 'a__adj' -> 'ar__vblex', stem -> 'gap'
Fixed garantiar: changed paradigm 'a__adj' -> 'ar__vblex', stem -> 'garanti'
Fixed garar: changed paradigm 'a__adj' -> 'ar__vblex', stem -> 'gar'
Fixed gardar: changed paradigm 'a__adj' -> 'ar__vblex', stem -> 'gard'
Fixed gargarar: changed paradigm 'a__adj' -> 'ar__vblex', stem -> 'gargar'
Fixed garnisar: changed paradigm 'a__adj' -> 'ar__vblex', stem -> 'garnis'
Fixed gaujar: changed paradigm 'a__adj' -> 'ar__vblex', stem -> 'gauj'
Fixed gavar: changed paradigm 'a__adj' -> 'ar__vblex', stem -> 'gav'
Fixed genitar: changed paradigm 'a__adj' -> 'ar__vblex', stem -> 'genit'
Fixed gestar: changed paradigm 'a__adj' -> 'ar__vblex', stem -> 'gest'
Fixed gimnastikar: changed paradigm 'a__adj' -> 'ar__vblex', stem -> 'gimnastik'
Fixed gisar: changed paradigm 'a__adj' -> 'ar__vblex', stem -> 'gis'
Fixed glacar: changed paradigm 'a__adj' -> 'ar__vblex', stem -> 'glac'
Fixed glezar: changed paradigm 'a__adj' -> 'ar__vblex', stem -> 'glez'
Fixed glinar: changed paradigm 'a__adj' -> 'ar__vblex', stem -> 'glin'
Fixed gliptar: changed paradigm 'a__adj' -> 'ar__vblex', stem -> 'glipt'
Fixed glitar: changed paradigm 'a__adj' -> 'ar__vblex', stem -> 'glit'
Fixed gluglar: changed paradigm 'a__adj' -> 'ar__vblex', stem -> 'glugl'
Fixed glutar: changed paradigm 'a__adj' -> 'ar__vblex', stem -> 'glut'
Fixed glutinar: changed paradigm 'a__adj' -> 'ar__vblex', stem -> 'glutin'
Fixed gorgear: changed paradigm 'a__adj' -> 'ar__vblex', stem -> 'gorge'
Fixed gorgolar: changed paradigm 'a__adj' -> 'ar__vblex', stem -> 'gorgol'
Fixed grabar: changed paradigm 'a__adj' -> 'ar__vblex', stem -> 'grab'
Fixed grantar: changed paradigm 'a__adj' -> 'ar__vblex', stem -> 'grant'
Fixed gratar: changed paradigm 'a__adj' -> 'ar__vblex', stem -> 'grat'
Fixed gratifikar: changed paradigm 'a__adj' -> 'ar__vblex', stem -> 'gratifik'
Fixed gratitudar: changed paradigm 'a__adj' -> 'ar__vblex', stem -> 'gratitud'
Fixed gratular: changed paradigm 'a__adj' -> 'ar__vblex', stem -> 'gratul'
Fixed gravitar: changed paradigm 'a__adj' -> 'ar__vblex', stem -> 'gravit'
Fixed greftar: changed paradigm 'a__adj' -> 'ar__vblex', stem -> 'greft'
Fixed grelar: changed paradigm 'a__adj' -> 'ar__vblex', stem -> 'grel'
Fixed grilar: changed paradigm 'a__adj' -> 'ar__vblex', stem -> 'gril'
Fixed grimar: changed paradigm 'a__adj' -> 'ar__vblex', stem -> 'grim'
Fixed grimasar: changed paradigm 'a__adj' -> 'ar__vblex', stem -> 'grimas'
Fixed grincar: changed paradigm 'a__adj' -> 'ar__vblex', stem -> 'grinc'
Fixed grindar: changed paradigm 'a__adj' -> 'ar__vblex', stem -> 'grind'
Fixed grondar: changed paradigm 'a__adj' -> 'ar__vblex', stem -> 'grond'
Fixed grunar: changed paradigm 'a__adj' -> 'ar__vblex', stem -> 'grun'
Fixed guatar: changed paradigm 'a__adj' -> 'ar__vblex', stem -> 'guat'
Fixed guidar: changed paradigm 'a__adj' -> 'ar__vblex', stem -> 'guid'
Fixed gustar: changed paradigm 'a__adj' -> 'ar__vblex', stem -> 'gust'
Fixed guvernar: changed paradigm 'a__adj' -> 'ar__vblex', stem -> 'guvern'
Fixed haltar: changed paradigm 'a__adj' -> 'ar__vblex', stem -> 'halt'
Fixed hastar: changed paradigm 'a__adj' -> 'ar__vblex', stem -> 'hast'
Fixed helpar: changed paradigm 'a__adj' -> 'ar__vblex', stem -> 'help'
Fixed homajar: changed paradigm 'a__adj' -> 'ar__vblex', stem -> 'homaj'
Fixed identifikar: changed paradigm 'a__adj' -> 'ar__vblex', stem -> 'identifik'
Fixed igar: changed paradigm 'a__adj' -> 'ar__vblex', stem -> 'ig'
Fixed ignorar: changed paradigm 'a__adj' -> 'ar__vblex', stem -> 'ignor'
Fixed iluminar: changed paradigm 'a__adj' -> 'ar__vblex', stem -> 'ilumin'
Fixed ilustrar: changed paradigm 'a__adj' -> 'ar__vblex', stem -> 'ilustr'
Fixed iluzionar: changed paradigm 'a__adj' -> 'ar__vblex', stem -> 'iluzion'
Fixed imbastar: changed paradigm 'a__adj' -> 'ar__vblex', stem -> 'imbast'
Fixed imersar: changed paradigm 'a__adj' -> 'ar__vblex', stem -> 'imers'
Fixed imigrar: changed paradigm 'a__adj' -> 'ar__vblex', stem -> 'imigr'
Fixed imitar: changed paradigm 'a__adj' -> 'ar__vblex', stem -> 'imit'
Fixed impedar: changed paradigm 'a__adj' -> 'ar__vblex', stem -> 'imped'
Fixed imperar: changed paradigm 'a__adj' -> 'ar__vblex', stem -> 'imper'
Fixed implikar: changed paradigm 'a__adj' -> 'ar__vblex', stem -> 'implik'
Fixed importacar: changed paradigm 'a__adj' -> 'ar__vblex', stem -> 'importac'
Fixed importar: changed paradigm 'a__adj' -> 'ar__vblex', stem -> 'import'
Fixed impostado: changed lemma to 'impostada' (past participle), stem -> 'impostad'
Fixed impozar: changed paradigm 'a__adj' -> 'ar__vblex', stem -> 'impoz'
Fixed imprekar: changed paradigm 'a__adj' -> 'ar__vblex', stem -> 'imprek'
Fixed imprimar: changed paradigm 'a__adj' -> 'ar__vblex', stem -> 'imprim'
Fixed improvizar: changed paradigm 'a__adj' -> 'ar__vblex', stem -> 'improviz'
Fixed impulsar: changed paradigm 'a__adj' -> 'ar__vblex', stem -> 'impuls'
Fixed imputar: changed paradigm 'a__adj' -> 'ar__vblex', stem -> 'imput'
Fixed inaugurar: changed paradigm 'a__adj' -> 'ar__vblex', stem -> 'inaugur'
Fixed incendiar: changed paradigm 'a__adj' -> 'ar__vblex', stem -> 'incendi'
Fixed incestar: changed paradigm 'a__adj' -> 'ar__vblex', stem -> 'incest'
Fixed incitar: changed paradigm 'a__adj' -> 'ar__vblex', stem -> 'incit'
Fixed indignar: changed paradigm 'a__adj' -> 'ar__vblex', stem -> 'indign'
Fixed indijar: changed paradigm 'a__adj' -> 'ar__vblex', stem -> 'indij'
Fixed indikar: changed paradigm 'a__adj' -> 'ar__vblex', stem -> 'indik'
Fixed indosar: changed paradigm 'a__adj' -> 'ar__vblex', stem -> 'indos'
Fixed induktar: changed paradigm 'a__adj' -> 'ar__vblex', stem -> 'indukt'
Fixed indulgar: changed paradigm 'a__adj' -> 'ar__vblex', stem -> 'indulg'
Fixed indutar: changed paradigm 'a__adj' -> 'ar__vblex', stem -> 'indut'
Fixed infektar: changed paradigm 'a__adj' -> 'ar__vblex', stem -> 'infekt'
Fixed inferar: changed paradigm 'a__adj' -> 'ar__vblex', stem -> 'infer'
Fixed inflamar: changed paradigm 'a__adj' -> 'ar__vblex', stem -> 'inflam'
Fixed inflar: changed paradigm 'a__adj' -> 'ar__vblex', stem -> 'infl'
Fixed inflexar: changed paradigm 'a__adj' -> 'ar__vblex', stem -> 'inflex'
Fixed influar: changed paradigm 'a__adj' -> 'ar__vblex', stem -> 'influ'
Fixed informar: changed paradigm 'a__adj' -> 'ar__vblex', stem -> 'inform'
Fixed infuzar: changed paradigm 'a__adj' -> 'ar__vblex', stem -> 'infuz'
Fixed inglobar: changed paradigm 'a__adj' -> 'ar__vblex', stem -> 'inglob'
Fixed ingranar: changed paradigm 'a__adj' -> 'ar__vblex', stem -> 'ingran'
Fixed inhalar: changed paradigm 'a__adj' -> 'ar__vblex', stem -> 'inhal'
Fixed inherar: changed paradigm 'a__adj' -> 'ar__vblex', stem -> 'inher'
Fixed inhibar: changed paradigm 'a__adj' -> 'ar__vblex', stem -> 'inhib'
Fixed iniciar: changed paradigm 'a__adj' -> 'ar__vblex', stem -> 'inici'
Fixed injektar: changed paradigm 'a__adj' -> 'ar__vblex', stem -> 'injekt'
Fixed injeniar: changed paradigm 'a__adj' -> 'ar__vblex', stem -> 'injeni'
Fixed inkasar: changed paradigm 'a__adj' -> 'ar__vblex', stem -> 'inkas'
Fixed inkastrar: changed paradigm 'a__adj' -> 'ar__vblex', stem -> 'inkastr'
Fixed inklinar: changed paradigm 'a__adj' -> 'ar__vblex', stem -> 'inklin'
Fixed inkluzar: changed paradigm 'a__adj' -> 'ar__vblex', stem -> 'inkluz'
Fixed inkombrar: changed paradigm 'a__adj' -> 'ar__vblex', stem -> 'inkombr'
Fixed inkulkar: changed paradigm 'a__adj' -> 'ar__vblex', stem -> 'inkulk'
Fixed inkursar: changed paradigm 'a__adj' -> 'ar__vblex', stem -> 'inkurs'
Fixed inokular: changed paradigm 'a__adj' -> 'ar__vblex', stem -> 'inokul'
Fixed inquestar: changed paradigm 'a__adj' -> 'ar__vblex', stem -> 'inquest'
Fixed insertar: changed paradigm 'a__adj' -> 'ar__vblex', stem -> 'insert'
Fixed insidiar: changed paradigm 'a__adj' -> 'ar__vblex', stem -> 'insidi'
Fixed insinuar: changed paradigm 'a__adj' -> 'ar__vblex', stem -> 'insinu'
Fixed inspektar: changed paradigm 'a__adj' -> 'ar__vblex', stem -> 'inspekt'
Fixed inspirar: changed paradigm 'a__adj' -> 'ar__vblex', stem -> 'inspir'
Fixed instalar: changed paradigm 'a__adj' -> 'ar__vblex', stem -> 'instal'
Fixed instigar: changed paradigm 'a__adj' -> 'ar__vblex', stem -> 'instig'
Fixed institucar: changed paradigm 'a__adj' -> 'ar__vblex', stem -> 'instituc'
Fixed insultar: changed paradigm 'a__adj' -> 'ar__vblex', stem -> 'insult'
Fixed intelektar: changed paradigm 'a__adj' -> 'ar__vblex', stem -> 'intelekt'
Fixed intencar: changed paradigm 'a__adj' -> 'ar__vblex', stem -> 'intenc'
Fixed interceptar: changed paradigm 'a__adj' -> 'ar__vblex', stem -> 'intercept'
Fixed intercesar: changed paradigm 'a__adj' -> 'ar__vblex', stem -> 'interces'
Fixed interdiktar: changed paradigm 'a__adj' -> 'ar__vblex', stem -> 'interdikt'
Fixed interesar: changed paradigm 'a__adj' -> 'ar__vblex', stem -> 'interes'
Fixed interferar: changed paradigm 'a__adj' -> 'ar__vblex', stem -> 'interfer'
Fixed intermitar: changed paradigm 'a__adj' -> 'ar__vblex', stem -> 'intermit'
Fixed interpretar: changed paradigm 'a__adj' -> 'ar__vblex', stem -> 'interpret'
Fixed interviuvar: changed paradigm 'a__adj' -> 'ar__vblex', stem -> 'interviuv'
Fixed intonar: changed paradigm 'a__adj' -> 'ar__vblex', stem -> 'inton'
Fixed intoxikar: changed paradigm 'a__adj' -> 'ar__vblex', stem -> 'intoxik'
Fixed intrigar: changed paradigm 'a__adj' -> 'ar__vblex', stem -> 'intrig'
Fixed intrikar: changed paradigm 'a__adj' -> 'ar__vblex', stem -> 'intrik'
Fixed introduktar: changed paradigm 'a__adj' -> 'ar__vblex', stem -> 'introdukt'
Fixed intuicar: changed paradigm 'a__adj' -> 'ar__vblex', stem -> 'intuic'
Fixed inundado: changed lemma to 'inundada' (past participle), stem -> 'inundad'
Fixed invadar: changed paradigm 'a__adj' -> 'ar__vblex', stem -> 'invad'
Fixed inventar: changed paradigm 'a__adj' -> 'ar__vblex', stem -> 'invent'
Fixed investar: changed paradigm 'a__adj' -> 'ar__vblex', stem -> 'invest'
Fixed invitar: changed paradigm 'a__adj' -> 'ar__vblex', stem -> 'invit'
Fixed iracar: changed paradigm 'a__adj' -> 'ar__vblex', stem -> 'irac'
Fixed iradiar: changed paradigm 'a__adj' -> 'ar__vblex', stem -> 'iradi'
Fixed irar: changed paradigm 'a__adj' -> 'ar__vblex', stem -> 'ir'
Fixed irigacar: changed paradigm 'a__adj' -> 'ar__vblex', stem -> 'irigac'
Fixed iritar: changed paradigm 'a__adj' -> 'ar__vblex', stem -> 'irit'
Fixed iterar: changed paradigm 'a__adj' -> 'ar__vblex', stem -> 'iter'
Fixed izolar: changed paradigm 'a__adj' -> 'ar__vblex', stem -> 'izol'
Fixed jacar: changed paradigm 'a__adj' -> 'ar__vblex', stem -> 'jac'
Fixed jargonar: changed paradigm 'a__adj' -> 'ar__vblex', stem -> 'jargon'
Fixed jemar: changed paradigm 'a__adj' -> 'ar__vblex', stem -> 'jem'
Fixed jenar: changed paradigm 'a__adj' -> 'ar__vblex', stem -> 'jen'
Fixed jetar: changed paradigm 'a__adj' -> 'ar__vblex', stem -> 'jet'
Fixed jirar: changed paradigm 'a__adj' -> 'ar__vblex', stem -> 'jir'
Fixed jokar: changed paradigm 'a__adj' -> 'ar__vblex', stem -> 'jok'
Fixed jonglar: changed paradigm 'a__adj' -> 'ar__vblex', stem -> 'jongl'
Fixed joyar: changed paradigm 'a__adj' -> 'ar__vblex', stem -> 'joy'
Fixed juar: changed paradigm 'a__adj' -> 'ar__vblex', stem -> 'ju'
Fixed jubilear: changed paradigm 'a__adj' -> 'ar__vblex', stem -> 'jubile'
Fixed judiciar: changed paradigm 'a__adj' -> 'ar__vblex', stem -> 'judici'
Fixed judikar: changed paradigm 'a__adj' -> 'ar__vblex', stem -> 'judik'
Fixed jungar: changed paradigm 'a__adj' -> 'ar__vblex', stem -> 'jung'
Fixed juntar: changed paradigm 'a__adj' -> 'ar__vblex', stem -> 'junt'
Fixed jurar: changed paradigm 'a__adj' -> 'ar__vblex', stem -> 'jur'
Fixed justifikar: changed paradigm 'a__adj' -> 'ar__vblex', stem -> 'justifik'
Fixed kabrar: changed paradigm 'a__adj' -> 'ar__vblex', stem -> 'kabr'
Fixed kakar: changed paradigm 'a__adj' -> 'ar__vblex', stem -> 'kak'
Fixed kalandrar: changed paradigm 'a__adj' -> 'ar__vblex', stem -> 'kalandr'
Fixed kaligrafar: changed paradigm 'a__adj' -> 'ar__vblex', stem -> 'kaligraf'
Fixed kalkular: changed paradigm 'a__adj' -> 'ar__vblex', stem -> 'kalkul'
Fixed kalumniar: changed paradigm 'a__adj' -> 'ar__vblex', stem -> 'kalumni'
Fixed kambiar: changed paradigm 'a__adj' -> 'ar__vblex', stem -> 'kambi'
Fixed kampaniar: changed paradigm 'a__adj' -> 'ar__vblex', stem -> 'kampani'
Fixed kampar: changed paradigm 'a__adj' -> 'ar__vblex', stem -> 'kamp'
Fixed kantar: changed paradigm 'a__adj' -> 'ar__vblex', stem -> 'kant'
Fixed kapitulacar: changed paradigm 'a__adj' -> 'ar__vblex', stem -> 'kapitulac'
Fixed kapriolar: changed paradigm 'a__adj' -> 'ar__vblex', stem -> 'kapriol'
Fixed kaptacar: changed paradigm 'a__adj' -> 'ar__vblex', stem -> 'kaptac'
Fixed kaptar: changed paradigm 'a__adj' -> 'ar__vblex', stem -> 'kapt'
Fixed kardar: changed paradigm 'a__adj' -> 'ar__vblex', stem -> 'kard'
Fixed karear: changed paradigm 'a__adj' -> 'ar__vblex', stem -> 'kare'
Fixed karezar: changed paradigm 'a__adj' -> 'ar__vblex', stem -> 'karez'
Fixed kargar: changed paradigm 'a__adj' -> 'ar__vblex', stem -> 'karg'
Fixed kariar: changed paradigm 'a__adj' -> 'ar__vblex', stem -> 'kari'
Fixed karikatar: changed paradigm 'a__adj' -> 'ar__vblex', stem -> 'karikat'
Fixed karpentar: changed paradigm 'a__adj' -> 'ar__vblex', stem -> 'karpent'
Fixed kasacar: changed paradigm 'a__adj' -> 'ar__vblex', stem -> 'kasac'
Fixed kastrar: changed paradigm 'a__adj' -> 'ar__vblex', stem -> 'kastr'
Fixed kavalkar: changed paradigm 'a__adj' -> 'ar__vblex', stem -> 'kavalk'
Fixed kikar: changed paradigm 'a__adj' -> 'ar__vblex', stem -> 'kik'
Fixed kisar: changed paradigm 'a__adj' -> 'ar__vblex', stem -> 'kis'
Fixed klakar: changed paradigm 'a__adj' -> 'ar__vblex', stem -> 'klak'
Fixed klamar: changed paradigm 'a__adj' -> 'ar__vblex', stem -> 'klam'
Fixed klasifikar: changed paradigm 'a__adj' -> 'ar__vblex', stem -> 'klasifik'
Fixed klaudikar: changed paradigm 'a__adj' -> 'ar__vblex', stem -> 'klaudik'
Fixed klemar: changed paradigm 'a__adj' -> 'ar__vblex', stem -> 'klem'
Fixed kliktar: changed paradigm 'a__adj' -> 'ar__vblex', stem -> 'klikt'
Fixed klimar: changed paradigm 'a__adj' -> 'ar__vblex', stem -> 'klim'
Fixed klinar: changed paradigm 'a__adj' -> 'ar__vblex', stem -> 'klin'
Fixed klozar: changed paradigm 'a__adj' -> 'ar__vblex', stem -> 'kloz'
Fixed klukar: changed paradigm 'a__adj' -> 'ar__vblex', stem -> 'kluk'
Fixed koaktar: changed paradigm 'a__adj' -> 'ar__vblex', stem -> 'koakt'
Fixed koalisar: changed paradigm 'a__adj' -> 'ar__vblex', stem -> 'koalis'
Fixed koherar: changed paradigm 'a__adj' -> 'ar__vblex', stem -> 'koher'
Fixed koincidar: changed paradigm 'a__adj' -> 'ar__vblex', stem -> 'koincid'
Fixed koitar: changed paradigm 'a__adj' -> 'ar__vblex', stem -> 'koit'
Fixed kolikar: changed paradigm 'a__adj' -> 'ar__vblex', stem -> 'kolik'
Fixed kolizionar: changed paradigm 'a__adj' -> 'ar__vblex', stem -> 'kolizion'
Fixed kolokar: changed paradigm 'a__adj' -> 'ar__vblex', stem -> 'kolok'
Fixed komandar: changed paradigm 'a__adj' -> 'ar__vblex', stem -> 'komand'
Fixed komanditar: changed paradigm 'a__adj' -> 'ar__vblex', stem -> 'komandit'
Fixed kombatar: changed paradigm 'a__adj' -> 'ar__vblex', stem -> 'kombat'
Fixed kombinar: changed paradigm 'a__adj' -> 'ar__vblex', stem -> 'kombin'
Fixed kombustar: changed paradigm 'a__adj' -> 'ar__vblex', stem -> 'kombust'
Fixed komencar: changed paradigm 'a__adj' -> 'ar__vblex', stem -> 'komenc'
Fixed komendar: changed paradigm 'a__adj' -> 'ar__vblex', stem -> 'komend'
Fixed komentar: changed paradigm 'a__adj' -> 'ar__vblex', stem -> 'koment'
Fixed komercar: changed paradigm 'a__adj' -> 'ar__vblex', stem -> 'komerc'
Fixed komisar: changed paradigm 'a__adj' -> 'ar__vblex', stem -> 'komis'
Fixed komparar: changed paradigm 'a__adj' -> 'ar__vblex', stem -> 'kompar'
Fixed kompatar: changed paradigm 'a__adj' -> 'ar__vblex', stem -> 'kompat'
Fixed kompensar: changed paradigm 'a__adj' -> 'ar__vblex', stem -> 'kompens'
Fixed kompilar: changed paradigm 'a__adj' -> 'ar__vblex', stem -> 'kompil'
Fixed komplezar: changed paradigm 'a__adj' -> 'ar__vblex', stem -> 'komplez'
Fixed komplikar: changed paradigm 'a__adj' -> 'ar__vblex', stem -> 'komplik'
Fixed komplimentar: changed paradigm 'a__adj' -> 'ar__vblex', stem -> 'kompliment'
Fixed komplotar: changed paradigm 'a__adj' -> 'ar__vblex', stem -> 'komplot'
Fixed kompostar: changed paradigm 'a__adj' -> 'ar__vblex', stem -> 'kompost'
Fixed kompozar: changed paradigm 'a__adj' -> 'ar__vblex', stem -> 'kompoz'
Fixed komprar: changed paradigm 'a__adj' -> 'ar__vblex', stem -> 'kompr'
Fixed komprenar: changed paradigm 'a__adj' -> 'ar__vblex', stem -> 'kompren'
Fixed kompresar: changed paradigm 'a__adj' -> 'ar__vblex', stem -> 'kompres'
Fixed kompromisar: changed paradigm 'a__adj' -> 'ar__vblex', stem -> 'kompromis'
Fixed komputar: changed paradigm 'a__adj' -> 'ar__vblex', stem -> 'komput'
Fixed komuniar: changed paradigm 'a__adj' -> 'ar__vblex', stem -> 'komuni'
Fixed komunikar: changed paradigm 'a__adj' -> 'ar__vblex', stem -> 'komunik'
Fixed komutar: changed paradigm 'a__adj' -> 'ar__vblex', stem -> 'komut'
Fixed koncentrar: changed paradigm 'a__adj' -> 'ar__vblex', stem -> 'koncentr'
Fixed konceptar: changed paradigm 'a__adj' -> 'ar__vblex', stem -> 'koncept'
Fixed koncernar: changed paradigm 'a__adj' -> 'ar__vblex', stem -> 'koncern'
Fixed koncertar: changed paradigm 'a__adj' -> 'ar__vblex', stem -> 'koncert'
Fixed koncesar: changed paradigm 'a__adj' -> 'ar__vblex', stem -> 'konces'
Fixed koncesionar: changed paradigm 'a__adj' -> 'ar__vblex', stem -> 'koncesion'
Fixed konciar: changed paradigm 'a__adj' -> 'ar__vblex', stem -> 'konci'
Fixed konciliar: changed paradigm 'a__adj' -> 'ar__vblex', stem -> 'koncili'
Fixed kondamnar: changed paradigm 'a__adj' -> 'ar__vblex', stem -> 'kondamn'
Fixed kondensar: changed paradigm 'a__adj' -> 'ar__vblex', stem -> 'kondens'
Fixed kondolar: changed paradigm 'a__adj' -> 'ar__vblex', stem -> 'kondol'
Fixed konduktar: changed paradigm 'a__adj' -> 'ar__vblex', stem -> 'kondukt'
Fixed kondutar: changed paradigm 'a__adj' -> 'ar__vblex', stem -> 'kondut'
Fixed konektar: changed paradigm 'a__adj' -> 'ar__vblex', stem -> 'konekt'
Fixed konfecionar: changed paradigm 'a__adj' -> 'ar__vblex', stem -> 'konfecion'
Fixed konferar: changed paradigm 'a__adj' -> 'ar__vblex', stem -> 'konfer'
Fixed konfesar: changed paradigm 'a__adj' -> 'ar__vblex', stem -> 'konfes'
Fixed konfidar: changed paradigm 'a__adj' -> 'ar__vblex', stem -> 'konfid'
Fixed konfidencar: changed paradigm 'a__adj' -> 'ar__vblex', stem -> 'konfidenc'
Fixed konfirmar: changed paradigm 'a__adj' -> 'ar__vblex', stem -> 'konfirm'
Fixed konfiskar: changed paradigm 'a__adj' -> 'ar__vblex', stem -> 'konfisk'
Fixed konfliktar: changed paradigm 'a__adj' -> 'ar__vblex', stem -> 'konflikt'
Fixed konfrontar: changed paradigm 'a__adj' -> 'ar__vblex', stem -> 'konfront'
Fixed konfundar: changed paradigm 'a__adj' -> 'ar__vblex', stem -> 'konfund'
Fixed kongresar: changed paradigm 'a__adj' -> 'ar__vblex', stem -> 'kongres'
Fixed kongruar: changed paradigm 'a__adj' -> 'ar__vblex', stem -> 'kongru'
Fixed konjedar: changed paradigm 'a__adj' -> 'ar__vblex', stem -> 'konjed'
Fixed konjektar: changed paradigm 'a__adj' -> 'ar__vblex', stem -> 'konjekt'
Fixed konjelar: changed paradigm 'a__adj' -> 'ar__vblex', stem -> 'konjel'
Fixed konjestionar: changed paradigm 'a__adj' -> 'ar__vblex', stem -> 'konjestion'
Fixed konjugar: changed paradigm 'a__adj' -> 'ar__vblex', stem -> 'konjug'
Fixed konkluzar: changed paradigm 'a__adj' -> 'ar__vblex', stem -> 'konkluz'
Fixed konkordar: changed paradigm 'a__adj' -> 'ar__vblex', stem -> 'konkord'
Fixed konkurencar: changed paradigm 'a__adj' -> 'ar__vblex', stem -> 'konkurenc'
Fixed konkursar: changed paradigm 'a__adj' -> 'ar__vblex', stem -> 'konkurs'
Fixed konocar: changed paradigm 'a__adj' -> 'ar__vblex', stem -> 'konoc'
Fixed konquestar: changed paradigm 'a__adj' -> 'ar__vblex', stem -> 'konquest'
Fixed konsakrar: changed paradigm 'a__adj' -> 'ar__vblex', stem -> 'konsakr'
Fixed konsentar: changed paradigm 'a__adj' -> 'ar__vblex', stem -> 'konsent'
Fixed konsequar: changed paradigm 'a__adj' -> 'ar__vblex', stem -> 'konsequ'
Fixed konservar: changed paradigm 'a__adj' -> 'ar__vblex', stem -> 'konserv'
Fixed konsiderar: changed paradigm 'a__adj' -> 'ar__vblex', stem -> 'konsider'
Fixed konsignar: changed paradigm 'a__adj' -> 'ar__vblex', stem -> 'konsign'
Fixed konsilar: changed paradigm 'a__adj' -> 'ar__vblex', stem -> 'konsil'
Fixed konsistar: changed paradigm 'a__adj' -> 'ar__vblex', stem -> 'konsist'
Fixed konskriptar: changed paradigm 'a__adj' -> 'ar__vblex', stem -> 'konskript'
Fixed konsolacar: changed paradigm 'a__adj' -> 'ar__vblex', stem -> 'konsolac'
Fixed konspirar: changed paradigm 'a__adj' -> 'ar__vblex', stem -> 'konspir'
Fixed konsputar: changed paradigm 'a__adj' -> 'ar__vblex', stem -> 'konsput'
Fixed konstatar: changed paradigm 'a__adj' -> 'ar__vblex', stem -> 'konstat'
Fixed konsternar: changed paradigm 'a__adj' -> 'ar__vblex', stem -> 'konstern'
Fixed konstipar: changed paradigm 'a__adj' -> 'ar__vblex', stem -> 'konstip'
Fixed konstitucar: changed paradigm 'a__adj' -> 'ar__vblex', stem -> 'konstituc'
Fixed konstriktar: changed paradigm 'a__adj' -> 'ar__vblex', stem -> 'konstrikt'
Fixed konstruktar: changed paradigm 'a__adj' -> 'ar__vblex', stem -> 'konstrukt'
Fixed konsultar: changed paradigm 'a__adj' -> 'ar__vblex', stem -> 'konsult'
Fixed kontagiar: changed paradigm 'a__adj' -> 'ar__vblex', stem -> 'kontagi'
Fixed kontaktar: changed paradigm 'a__adj' -> 'ar__vblex', stem -> 'kontakt'
Fixed kontaminar: changed paradigm 'a__adj' -> 'ar__vblex', stem -> 'kontamin'
Fixed kontar: changed paradigm 'a__adj' -> 'ar__vblex', stem -> 'kont'
Fixed kontemplar: changed paradigm 'a__adj' -> 'ar__vblex', stem -> 'kontempl'
Fixed kontenar: changed paradigm 'a__adj' -> 'ar__vblex', stem -> 'konten'
Fixed kontestar: changed paradigm 'a__adj' -> 'ar__vblex', stem -> 'kontest'
Fixed kontinencar: changed paradigm 'a__adj' -> 'ar__vblex', stem -> 'kontinenc'
Fixed kontrabandar: changed paradigm 'a__adj' -> 'ar__vblex', stem -> 'kontraband'
Fixed kontrafaktar: changed paradigm 'a__adj' -> 'ar__vblex', stem -> 'kontrafakt'
Fixed kontraktar: changed paradigm 'a__adj' -> 'ar__vblex', stem -> 'kontrakt'
Fixed kontrastar: changed paradigm 'a__adj' -> 'ar__vblex', stem -> 'kontrast'
Fixed kontratar: changed paradigm 'a__adj' -> 'ar__vblex', stem -> 'kontrat'
Fixed kontravencar: changed paradigm 'a__adj' -> 'ar__vblex', stem -> 'kontravenc'
Fixed kontributar: changed paradigm 'a__adj' -> 'ar__vblex', stem -> 'kontribut'
Fixed kontrolar: changed paradigm 'a__adj' -> 'ar__vblex', stem -> 'kontrol'
Fixed kontroversar: changed paradigm 'a__adj' -> 'ar__vblex', stem -> 'kontrovers'
Fixed kontuzar: changed paradigm 'a__adj' -> 'ar__vblex', stem -> 'kontuz'
Fixed konvalecar: changed paradigm 'a__adj' -> 'ar__vblex', stem -> 'konvalec'
Fixed konvencionar: changed paradigm 'a__adj' -> 'ar__vblex', stem -> 'konvencion'
Fixed konvergar: changed paradigm 'a__adj' -> 'ar__vblex', stem -> 'konverg'
Fixed konversar: changed paradigm 'a__adj' -> 'ar__vblex', stem -> 'konvers'
Fixed konvertar: changed paradigm 'a__adj' -> 'ar__vblex', stem -> 'konvert'
Fixed konvinkar: changed paradigm 'a__adj' -> 'ar__vblex', stem -> 'konvink'
Fixed konvoyar: changed paradigm 'a__adj' -> 'ar__vblex', stem -> 'konvoy'
Fixed konvulsar: changed paradigm 'a__adj' -> 'ar__vblex', stem -> 'konvuls'
Fixed kooperar: changed paradigm 'a__adj' -> 'ar__vblex', stem -> 'kooper'
Fixed koordinar: changed paradigm 'a__adj' -> 'ar__vblex', stem -> 'koordin'
Fixed kopiar: changed paradigm 'a__adj' -> 'ar__vblex', stem -> 'kopi'
Fixed kopulacar: changed paradigm 'a__adj' -> 'ar__vblex', stem -> 'kopulac'
Fixed koquar: changed paradigm 'a__adj' -> 'ar__vblex', stem -> 'koqu'
Fixed korelatar: changed paradigm 'a__adj' -> 'ar__vblex', stem -> 'korelat'
Fixed korespondar: changed paradigm 'a__adj' -> 'ar__vblex', stem -> 'korespond'
Fixed korodar: changed paradigm 'a__adj' -> 'ar__vblex', stem -> 'korod'
Fixed kovar: changed paradigm 'a__adj' -> 'ar__vblex', stem -> 'kov'
Fixed kovrar: changed paradigm 'a__adj' -> 'ar__vblex', stem -> 'kovr'
Fixed krakar: changed paradigm 'a__adj' -> 'ar__vblex', stem -> 'krak'
Fixed krear: changed paradigm 'a__adj' -> 'ar__vblex', stem -> 'kre'
Fixed kredar: changed paradigm 'a__adj' -> 'ar__vblex', stem -> 'kred'
Fixed kreditar: changed paradigm 'a__adj' -> 'ar__vblex', stem -> 'kredit'
Fixed kremacar: changed paradigm 'a__adj' -> 'ar__vblex', stem -> 'kremac'
Fixed krepitar: changed paradigm 'a__adj' -> 'ar__vblex', stem -> 'krepit'
Fixed kreskar: changed paradigm 'a__adj' -> 'ar__vblex', stem -> 'kresk'
Fixed krevar: changed paradigm 'a__adj' -> 'ar__vblex', stem -> 'krev'
Fixed krevisar: changed paradigm 'a__adj' -> 'ar__vblex', stem -> 'krevis'
Fixed kriar: changed paradigm 'a__adj' -> 'ar__vblex', stem -> 'kri'
Fixed kriminaligar: changed paradigm 'a__adj' -> 'ar__vblex', stem -> 'kriminalig'
Fixed kriptografar: changed paradigm 'a__adj' -> 'ar__vblex', stem -> 'kriptograf'
Fixed kritikar: changed paradigm 'a__adj' -> 'ar__vblex', stem -> 'kritik'
Fixed kroasar: changed paradigm 'a__adj' -> 'ar__vblex', stem -> 'kroas'
Fixed krochar: changed paradigm 'a__adj' -> 'ar__vblex', stem -> 'kroch'
Fixed krokar: changed paradigm 'a__adj' -> 'ar__vblex', stem -> 'krok'
Fixed krozar: changed paradigm 'a__adj' -> 'ar__vblex', stem -> 'kroz'
Fixed krular: changed paradigm 'a__adj' -> 'ar__vblex', stem -> 'krul'
Fixed krumplar: changed paradigm 'a__adj' -> 'ar__vblex', stem -> 'krumpl'
Fixed kuafar: changed paradigm 'a__adj' -> 'ar__vblex', stem -> 'kuaf'
Fixed kulminar: changed paradigm 'a__adj' -> 'ar__vblex', stem -> 'kulmin'
Fixed kulpar: changed paradigm 'a__adj' -> 'ar__vblex', stem -> 'kulp'
Fixed kultar: changed paradigm 'a__adj' -> 'ar__vblex', stem -> 'kult'
Fixed kultivar: changed paradigm 'a__adj' -> 'ar__vblex', stem -> 'kultiv'
Fixed kunilingar: changed paradigm 'a__adj' -> 'ar__vblex', stem -> 'kuniling'
Fixed kuplar: changed paradigm 'a__adj' -> 'ar__vblex', stem -> 'kupl'
Fixed kuracar: changed paradigm 'a__adj' -> 'ar__vblex', stem -> 'kurac'
Fixed kurajar: changed paradigm 'a__adj' -> 'ar__vblex', stem -> 'kuraj'
Fixed kurtajar: changed paradigm 'a__adj' -> 'ar__vblex', stem -> 'kurtaj'
Fixed kurtezar: changed paradigm 'a__adj' -> 'ar__vblex', stem -> 'kurtez'
Fixed kushar: changed paradigm 'a__adj' -> 'ar__vblex', stem -> 'kush'
Fixed kustar: changed paradigm 'a__adj' -> 'ar__vblex', stem -> 'kust'
Fixed kustumar: changed paradigm 'a__adj' -> 'ar__vblex', stem -> 'kustum'
Fixed laborado: changed lemma to 'laborada' (past participle), stem -> 'laborad'
Fixed lacerar: changed paradigm 'a__adj' -> 'ar__vblex', stem -> 'lacer'
Fixed lamentar: changed paradigm 'a__adj' -> 'ar__vblex', stem -> 'lament'
Fixed laminar: changed paradigm 'a__adj' -> 'ar__vblex', stem -> 'lamin'
Fixed langorar: changed paradigm 'a__adj' -> 'ar__vblex', stem -> 'langor'
Fixed lansar: changed paradigm 'a__adj' -> 'ar__vblex', stem -> 'lans'
Fixed lapar: changed paradigm 'a__adj' -> 'ar__vblex', stem -> 'lap'
Fixed lasar: changed paradigm 'a__adj' -> 'ar__vblex', stem -> 'las'
Fixed laudar: changed paradigm 'a__adj' -> 'ar__vblex', stem -> 'laud'
Fixed lavar: changed paradigm 'a__adj' -> 'ar__vblex', stem -> 'lav'
Fixed legacar: changed paradigm 'a__adj' -> 'ar__vblex', stem -> 'legac'
Fixed lekar: changed paradigm 'a__adj' -> 'ar__vblex', stem -> 'lek'
Fixed lektar: changed paradigm 'a__adj' -> 'ar__vblex', stem -> 'lekt'
Fixed lernar: changed paradigm 'a__adj' -> 'ar__vblex', stem -> 'lern'
Fixed lesivar: changed paradigm 'a__adj' -> 'ar__vblex', stem -> 'lesiv'
Fixed levar: changed paradigm 'a__adj' -> 'ar__vblex', stem -> 'lev'
Fixed lezar: changed paradigm 'a__adj' -> 'ar__vblex', stem -> 'lez'
Fixed licencar: changed paradigm 'a__adj' -> 'ar__vblex', stem -> 'licenc'
Fixed ligar: changed paradigm 'a__adj' -> 'ar__vblex', stem -> 'lig'
Fixed likar: changed paradigm 'a__adj' -> 'ar__vblex', stem -> 'lik'
Fixed limar: changed paradigm 'a__adj' -> 'ar__vblex', stem -> 'lim'
Fixed liquidacar: changed paradigm 'a__adj' -> 'ar__vblex', stem -> 'liquidac'
Fixed litografar: changed paradigm 'a__adj' -> 'ar__vblex', stem -> 'litograf'
Fixed livar: changed paradigm 'a__adj' -> 'ar__vblex', stem -> 'liv'
Fixed livrar: changed paradigm 'a__adj' -> 'ar__vblex', stem -> 'livr'
Fixed locionar: changed paradigm 'a__adj' -> 'ar__vblex', stem -> 'locion'
Fixed lojar: changed paradigm 'a__adj' -> 'ar__vblex', stem -> 'loj'
Fixed lokacar: changed paradigm 'a__adj' -> 'ar__vblex', stem -> 'lokac'
Fixed lokomocar: changed paradigm 'a__adj' -> 'ar__vblex', stem -> 'lokomoc'
Fixed lotriar: changed paradigm 'a__adj' -> 'ar__vblex', stem -> 'lotri'
Fixed lubrifikar: changed paradigm 'a__adj' -> 'ar__vblex', stem -> 'lubrifik'
Fixed lugar: changed paradigm 'a__adj' -> 'ar__vblex', stem -> 'lug'
Fixed luktar: changed paradigm 'a__adj' -> 'ar__vblex', stem -> 'lukt'
Fixed lular: changed paradigm 'a__adj' -> 'ar__vblex', stem -> 'lul'
Fixed lumar: changed paradigm 'a__adj' -> 'ar__vblex', stem -> 'lum'
Fixed lurar: changed paradigm 'a__adj' -> 'ar__vblex', stem -> 'lur'
Fixed luxacar: changed paradigm 'a__adj' -> 'ar__vblex', stem -> 'luxac'
Fixed macerar: changed paradigm 'a__adj' -> 'ar__vblex', stem -> 'macer'
Fixed magiar: changed paradigm 'a__adj' -> 'ar__vblex', stem -> 'magi'
Fixed maledikar: changed paradigm 'a__adj' -> 'ar__vblex', stem -> 'maledik'
Fixed manifestar: changed paradigm 'a__adj' -> 'ar__vblex', stem -> 'manifest'
Fixed manipular: changed paradigm 'a__adj' -> 'ar__vblex', stem -> 'manipul'
Fixed manjar: changed paradigm 'a__adj' -> 'ar__vblex', stem -> 'manj'
Fixed mankar: changed paradigm 'a__adj' -> 'ar__vblex', stem -> 'mank'
Fixed manovrar: changed paradigm 'a__adj' -> 'ar__vblex', stem -> 'manovr'
Fixed mantenar: changed paradigm 'a__adj' -> 'ar__vblex', stem -> 'manten'
Fixed manuagar: changed paradigm 'a__adj' -> 'ar__vblex', stem -> 'manuag'
Fixed marchandar: changed paradigm 'a__adj' -> 'ar__vblex', stem -> 'marchand'
Fixed marchar: changed paradigm 'a__adj' -> 'ar__vblex', stem -> 'march'
Fixed mariajar: changed paradigm 'a__adj' -> 'ar__vblex', stem -> 'mariaj'
Fixed marinar: changed paradigm 'a__adj' -> 'ar__vblex', stem -> 'marin'
Fixed markotar: changed paradigm 'a__adj' -> 'ar__vblex', stem -> 'markot'
Fixed marodar: changed paradigm 'a__adj' -> 'ar__vblex', stem -> 'marod'
Fixed masajar: changed paradigm 'a__adj' -> 'ar__vblex', stem -> 'masaj'
Fixed masakrar: changed paradigm 'a__adj' -> 'ar__vblex', stem -> 'masakr'
Fixed mashinacar: changed paradigm 'a__adj' -> 'ar__vblex', stem -> 'mashinac'
Fixed maskar: changed paradigm 'a__adj' -> 'ar__vblex', stem -> 'mask'
Fixed masonar: changed paradigm 'a__adj' -> 'ar__vblex', stem -> 'mason'
Fixed mastikar: changed paradigm 'a__adj' -> 'ar__vblex', stem -> 'mastik'
Fixed meditar: changed paradigm 'a__adj' -> 'ar__vblex', stem -> 'medit'
Fixed mejisar: changed paradigm 'a__adj' -> 'ar__vblex', stem -> 'mejis'
Fixed melkar: changed paradigm 'a__adj' -> 'ar__vblex', stem -> 'melk'
Fixed memorar: changed paradigm 'a__adj' -> 'ar__vblex', stem -> 'memor'
Fixed mencionar: changed paradigm 'a__adj' -> 'ar__vblex', stem -> 'mencion'
Fixed mendikar: changed paradigm 'a__adj' -> 'ar__vblex', stem -> 'mendik'
Fixed menstruar: changed paradigm 'a__adj' -> 'ar__vblex', stem -> 'menstru'
Fixed mentiar: changed paradigm 'a__adj' -> 'ar__vblex', stem -> 'menti'
Fixed menuzar: changed paradigm 'a__adj' -> 'ar__vblex', stem -> 'menuz'
Fixed meritar: changed paradigm 'a__adj' -> 'ar__vblex', stem -> 'merit'
Fixed merkar: changed paradigm 'a__adj' -> 'ar__vblex', stem -> 'merk'
Fixed metamorfosar: changed paradigm 'a__adj' -> 'ar__vblex', stem -> 'metamorfos'
Fixed metar: changed paradigm 'a__adj' -> 'ar__vblex', stem -> 'met'
Fixed mezurar: changed paradigm 'a__adj' -> 'ar__vblex', stem -> 'mezur'
Fixed miaular: changed paradigm 'a__adj' -> 'ar__vblex', stem -> 'miaul'
Fixed migrar: changed paradigm 'a__adj' -> 'ar__vblex', stem -> 'migr'
Fixed militar: changed paradigm 'a__adj' -> 'ar__vblex', stem -> 'milit'
Fixed mimar: changed paradigm 'a__adj' -> 'ar__vblex', stem -> 'mim'
Fixed minacar: changed paradigm 'a__adj' -> 'ar__vblex', stem -> 'minac'
Fixed minado: changed lemma to 'minada' (past participle), stem -> 'minad'
Fixed mistifikar: changed paradigm 'a__adj' -> 'ar__vblex', stem -> 'mistifik'
Fixed mixar: changed paradigm 'a__adj' -> 'ar__vblex', stem -> 'mix'
Fixed mizerar: changed paradigm 'a__adj' -> 'ar__vblex', stem -> 'mizer'
Fixed mobilizar: changed paradigm 'a__adj' -> 'ar__vblex', stem -> 'mobiliz'
Fixed moderar: changed paradigm 'a__adj' -> 'ar__vblex', stem -> 'moder'
Fixed modifikar: changed paradigm 'a__adj' -> 'ar__vblex', stem -> 'modifik'
Fixed modlar: changed paradigm 'a__adj' -> 'ar__vblex', stem -> 'modl'
Fixed modulacar: changed paradigm 'a__adj' -> 'ar__vblex', stem -> 'modulac'
Fixed mokar: changed paradigm 'a__adj' -> 'ar__vblex', stem -> 'mok'
Fixed moldar: changed paradigm 'a__adj' -> 'ar__vblex', stem -> 'mold'
Fixed molestar: changed paradigm 'a__adj' -> 'ar__vblex', stem -> 'molest'
Fixed montrar: changed paradigm 'a__adj' -> 'ar__vblex', stem -> 'montr'
Fixed mordar: changed paradigm 'a__adj' -> 'ar__vblex', stem -> 'mord'
Fixed mortar: changed paradigm 'a__adj' -> 'ar__vblex', stem -> 'mort'
Fixed movar: changed paradigm 'a__adj' -> 'ar__vblex', stem -> 'mov'
Fixed muelar: changed paradigm 'a__adj' -> 'ar__vblex', stem -> 'muel'
Fixed mujar: changed paradigm 'a__adj' -> 'ar__vblex', stem -> 'muj'
Fixed muldar: changed paradigm 'a__adj' -> 'ar__vblex', stem -> 'muld'
Fixed multiplikar: changed paradigm 'a__adj' -> 'ar__vblex', stem -> 'multiplik'
Fixed mungar: changed paradigm 'a__adj' -> 'ar__vblex', stem -> 'mung'
Fixed muntar: changed paradigm 'a__adj' -> 'ar__vblex', stem -> 'munt'
Fixed murmurar: changed paradigm 'a__adj' -> 'ar__vblex', stem -> 'murmur'
Fixed mustar: changed paradigm 'a__adj' -> 'ar__vblex', stem -> 'must'
Fixed muzikar: changed paradigm 'a__adj' -> 'ar__vblex', stem -> 'muzik'
Fixed naracar: changed paradigm 'a__adj' -> 'ar__vblex', stem -> 'narac'
Fixed narkotar: changed paradigm 'a__adj' -> 'ar__vblex', stem -> 'narkot'
Fixed natar: changed paradigm 'a__adj' -> 'ar__vblex', stem -> 'nat'
Fixed naufrajar: changed paradigm 'a__adj' -> 'ar__vblex', stem -> 'naufraj'
Fixed nauzear: changed paradigm 'a__adj' -> 'ar__vblex', stem -> 'nauze'
Fixed nebular: changed paradigm 'a__adj' -> 'ar__vblex', stem -> 'nebul'
Fixed negar: changed paradigm 'a__adj' -> 'ar__vblex', stem -> 'neg'
Fixed neglijar: changed paradigm 'a__adj' -> 'ar__vblex', stem -> 'neglij'
Fixed negociar: changed paradigm 'a__adj' -> 'ar__vblex', stem -> 'negoci'
Fixed nivar: changed paradigm 'a__adj' -> 'ar__vblex', stem -> 'niv'
Fixed nocar: changed paradigm 'a__adj' -> 'ar__vblex', stem -> 'noc'
Fixed noktar: changed paradigm 'a__adj' -> 'ar__vblex', stem -> 'nokt'
Fixed nomar: changed paradigm 'a__adj' -> 'ar__vblex', stem -> 'nom'
Fixed nominar: changed paradigm 'a__adj' -> 'ar__vblex', stem -> 'nomin'
Fixed notar: changed paradigm 'a__adj' -> 'ar__vblex', stem -> 'not'
Fixed notifikar: changed paradigm 'a__adj' -> 'ar__vblex', stem -> 'notifik'
Fixed obediar: changed paradigm 'a__adj' -> 'ar__vblex', stem -> 'obedi'
Fixed objecionar: changed paradigm 'a__adj' -> 'ar__vblex', stem -> 'objecion'
Fixed obligar: changed paradigm 'a__adj' -> 'ar__vblex', stem -> 'oblig'
Fixed obliterar: changed paradigm 'a__adj' -> 'ar__vblex', stem -> 'obliter'
Fixed obliviar: changed paradigm 'a__adj' -> 'ar__vblex', stem -> 'oblivi'
Fixed obsedar: changed paradigm 'a__adj' -> 'ar__vblex', stem -> 'obsed'
Fixed observar: changed paradigm 'a__adj' -> 'ar__vblex', stem -> 'observ'
Fixed obstruktar: changed paradigm 'a__adj' -> 'ar__vblex', stem -> 'obstrukt'
Fixed obtenar: changed paradigm 'a__adj' -> 'ar__vblex', stem -> 'obten'
Fixed ociar: changed paradigm 'a__adj' -> 'ar__vblex', stem -> 'oci'
Fixed ocidar: changed paradigm 'a__adj' -> 'ar__vblex', stem -> 'ocid'
Fixed ocilar: changed paradigm 'a__adj' -> 'ar__vblex', stem -> 'ocil'
Fixed ocitar: changed paradigm 'a__adj' -> 'ar__vblex', stem -> 'ocit'
Fixed odorar: changed paradigm 'a__adj' -> 'ar__vblex', stem -> 'odor'
Fixed ofensar: changed paradigm 'a__adj' -> 'ar__vblex', stem -> 'ofens'
Fixed oficiar: changed paradigm 'a__adj' -> 'ar__vblex', stem -> 'ofici'
Fixed ofrar: changed paradigm 'a__adj' -> 'ar__vblex', stem -> 'ofr'
Fixed oglar: changed paradigm 'a__adj' -> 'ar__vblex', stem -> 'ogl'
Fixed okupar: changed paradigm 'a__adj' -> 'ar__vblex', stem -> 'okup'
Fixed omisar: changed paradigm 'a__adj' -> 'ar__vblex', stem -> 'omis'
Fixed onaniar: changed paradigm 'a__adj' -> 'ar__vblex', stem -> 'onani'
Fixed operacar: changed paradigm 'a__adj' -> 'ar__vblex', stem -> 'operac'
Fixed opinionar: changed paradigm 'a__adj' -> 'ar__vblex', stem -> 'opinion'
Fixed oportar: changed paradigm 'a__adj' -> 'ar__vblex', stem -> 'oport'
Fixed opozar: changed paradigm 'a__adj' -> 'ar__vblex', stem -> 'opoz'
Fixed opresar: changed paradigm 'a__adj' -> 'ar__vblex', stem -> 'opres'
Fixed orlar: changed paradigm 'a__adj' -> 'ar__vblex', stem -> 'orl'
Fixed ornar: changed paradigm 'a__adj' -> 'ar__vblex', stem -> 'orn'
Fixed ostentar: changed paradigm 'a__adj' -> 'ar__vblex', stem -> 'ostent'
Fixed pacar: changed paradigm 'a__adj' -> 'ar__vblex', stem -> 'pac'
Fixed pafar: changed paradigm 'a__adj' -> 'ar__vblex', stem -> 'paf'
Fixed pagar: changed paradigm 'a__adj' -> 'ar__vblex', stem -> 'pag'
Fixed paktar: changed paradigm 'a__adj' -> 'ar__vblex', stem -> 'pakt'
Fixed palpar: changed paradigm 'a__adj' -> 'ar__vblex', stem -> 'palp'
Fixed palpitar: changed paradigm 'a__adj' -> 'ar__vblex', stem -> 'palpit'
Fixed panear: changed paradigm 'a__adj' -> 'ar__vblex', stem -> 'pane'
Fixed pansar: changed paradigm 'a__adj' -> 'ar__vblex', stem -> 'pans'
Fixed paradar: changed paradigm 'a__adj' -> 'ar__vblex', stem -> 'parad'
Fixed parafrazar: changed paradigm 'a__adj' -> 'ar__vblex', stem -> 'parafraz'
Fixed paralizar: changed paradigm 'a__adj' -> 'ar__vblex', stem -> 'paraliz'
Fixed pardonar: changed paradigm 'a__adj' -> 'ar__vblex', stem -> 'pardon'
Fixed pariar: changed paradigm 'a__adj' -> 'ar__vblex', stem -> 'pari'
Fixed parodiar: changed paradigm 'a__adj' -> 'ar__vblex', stem -> 'parodi'
Fixed parolar: changed paradigm 'a__adj' -> 'ar__vblex', stem -> 'parol'
Fixed parturar: changed paradigm 'a__adj' -> 'ar__vblex', stem -> 'partur'
Fixed pasajar: changed paradigm 'a__adj' -> 'ar__vblex', stem -> 'pasaj'
Fixed pasar: changed paradigm 'a__adj' -> 'ar__vblex', stem -> 'pas'
Fixed pasteurisar: changed paradigm 'a__adj' -> 'ar__vblex', stem -> 'pasteuris'
Fixed patar: changed paradigm 'a__adj' -> 'ar__vblex', stem -> 'pat'
Fixed patroliar: changed paradigm 'a__adj' -> 'ar__vblex', stem -> 'patroli'
Fixed pauzar: changed paradigm 'a__adj' -> 'ar__vblex', stem -> 'pauz'
Fixed pavorar: changed paradigm 'a__adj' -> 'ar__vblex', stem -> 'pavor'
Fixed pazar: changed paradigm 'a__adj' -> 'ar__vblex', stem -> 'paz'
Fixed pekar: changed paradigm 'a__adj' -> 'ar__vblex', stem -> 'pek'
Fixed pektar: changed paradigm 'a__adj' -> 'ar__vblex', stem -> 'pekt'
Fixed penar: changed paradigm 'a__adj' -> 'ar__vblex', stem -> 'pen'
Fixed pendar: changed paradigm 'a__adj' -> 'ar__vblex', stem -> 'pend'
Fixed pensado: changed lemma to 'pensada' (past participle), stem -> 'pensad'
Fixed pensionar: changed paradigm 'a__adj' -> 'ar__vblex', stem -> 'pension'
Fixed perceptar: changed paradigm 'a__adj' -> 'ar__vblex', stem -> 'percept'
Fixed perchar: changed paradigm 'a__adj' -> 'ar__vblex', stem -> 'perch'
Fixed perdar: changed paradigm 'a__adj' -> 'ar__vblex', stem -> 'perd'
Fixed perforar: changed paradigm 'a__adj' -> 'ar__vblex', stem -> 'perfor'
Fixed perifrazar: changed paradigm 'a__adj' -> 'ar__vblex', stem -> 'perifraz'
Fixed perisar: changed paradigm 'a__adj' -> 'ar__vblex', stem -> 'peris'
Fixed perkutar: changed paradigm 'a__adj' -> 'ar__vblex', stem -> 'perkut'
Fixed permear: changed paradigm 'a__adj' -> 'ar__vblex', stem -> 'perme'
Fixed permisar: changed paradigm 'a__adj' -> 'ar__vblex', stem -> 'permis'
Fixed permutar: changed paradigm 'a__adj' -> 'ar__vblex', stem -> 'permut'
Fixed persekutar: changed paradigm 'a__adj' -> 'ar__vblex', stem -> 'persekut'
Fixed persequar: changed paradigm 'a__adj' -> 'ar__vblex', stem -> 'persequ'
Fixed perseverar: changed paradigm 'a__adj' -> 'ar__vblex', stem -> 'persever'
Fixed persistar: changed paradigm 'a__adj' -> 'ar__vblex', stem -> 'persist'
Fixed persuadar: changed paradigm 'a__adj' -> 'ar__vblex', stem -> 'persuad'
Fixed perturbar: changed paradigm 'a__adj' -> 'ar__vblex', stem -> 'perturb'
Fixed peskar: changed paradigm 'a__adj' -> 'ar__vblex', stem -> 'pesk'
Fixed petrisar: changed paradigm 'a__adj' -> 'ar__vblex', stem -> 'petris'
Fixed petular: changed paradigm 'a__adj' -> 'ar__vblex', stem -> 'petul'
Fixed pezar: changed paradigm 'a__adj' -> 'ar__vblex', stem -> 'pez'
Fixed piknikar: changed paradigm 'a__adj' -> 'ar__vblex', stem -> 'piknik'
Fixed piktar: changed paradigm 'a__adj' -> 'ar__vblex', stem -> 'pikt'
Fixed pilgrimar: changed paradigm 'a__adj' -> 'ar__vblex', stem -> 'pilgrim'
Fixed pilotado: changed lemma to 'pilotada' (past participle), stem -> 'pilotad'
Fixed pinchar: changed paradigm 'a__adj' -> 'ar__vblex', stem -> 'pinch'
Fixed pipiar: changed paradigm 'a__adj' -> 'ar__vblex', stem -> 'pipi'
Fixed pisar: changed paradigm 'a__adj' -> 'ar__vblex', stem -> 'pis'
Fixed pistar: changed paradigm 'a__adj' -> 'ar__vblex', stem -> 'pist'
Fixed plajiar: changed paradigm 'a__adj' -> 'ar__vblex', stem -> 'plaji'
Fixed plantacar: changed paradigm 'a__adj' -> 'ar__vblex', stem -> 'plantac'
Fixed plaudar: changed paradigm 'a__adj' -> 'ar__vblex', stem -> 'plaud'
Fixed plear: changed paradigm 'a__adj' -> 'ar__vblex', stem -> 'ple'
Fixed pledar: changed paradigm 'a__adj' -> 'ar__vblex', stem -> 'pled'
Fixed plektar: changed paradigm 'a__adj' -> 'ar__vblex', stem -> 'plekt'
Fixed plendar: changed paradigm 'a__adj' -> 'ar__vblex', stem -> 'plend'
Fixed plisar: changed paradigm 'a__adj' -> 'ar__vblex', stem -> 'plis'
Fixed plorar: changed paradigm 'a__adj' -> 'ar__vblex', stem -> 'plor'
Fixed plugar: changed paradigm 'a__adj' -> 'ar__vblex', stem -> 'plug'
Fixed plunjar: changed paradigm 'a__adj' -> 'ar__vblex', stem -> 'plunj'
Fixed pluvar: changed paradigm 'a__adj' -> 'ar__vblex', stem -> 'pluv'
Fixed polemikar: changed paradigm 'a__adj' -> 'ar__vblex', stem -> 'polemik'
Fixed polisar: changed paradigm 'a__adj' -> 'ar__vblex', stem -> 'polis'
Fixed polkar: changed paradigm 'a__adj' -> 'ar__vblex', stem -> 'polk'
Fixed polutado: changed lemma to 'polutada' (past participle), stem -> 'polutad'
Fixed ponderar: changed paradigm 'a__adj' -> 'ar__vblex', stem -> 'ponder'
Fixed portar: changed paradigm 'a__adj' -> 'ar__vblex', stem -> 'port'
Fixed posedar: changed paradigm 'a__adj' -> 'ar__vblex', stem -> 'posed'
Fixed postular: changed paradigm 'a__adj' -> 'ar__vblex', stem -> 'postul'
Fixed posturar: changed paradigm 'a__adj' -> 'ar__vblex', stem -> 'postur'
Fixed povar: changed paradigm 'a__adj' -> 'ar__vblex', stem -> 'pov'
Fixed pozar: changed paradigm 'a__adj' -> 'ar__vblex', stem -> 'poz'
Fixed praktikar: changed paradigm 'a__adj' -> 'ar__vblex', stem -> 'praktik'
Fixed precedar: changed paradigm 'a__adj' -> 'ar__vblex', stem -> 'preced'
Fixed precipitar: changed paradigm 'a__adj' -> 'ar__vblex', stem -> 'precipit'
Fixed predikar: changed paradigm 'a__adj' -> 'ar__vblex', stem -> 'predik'
Fixed pregar: changed paradigm 'a__adj' -> 'ar__vblex', stem -> 'preg'
Fixed preludar: changed paradigm 'a__adj' -> 'ar__vblex', stem -> 'prelud'
Fixed prenar: changed paradigm 'a__adj' -> 'ar__vblex', stem -> 'pren'
Fixed preparar: changed paradigm 'a__adj' -> 'ar__vblex', stem -> 'prepar'
Fixed preponderar: changed paradigm 'a__adj' -> 'ar__vblex', stem -> 'preponder'
Fixed presar: changed paradigm 'a__adj' -> 'ar__vblex', stem -> 'pres'
Fixed preskriptar: changed paradigm 'a__adj' -> 'ar__vblex', stem -> 'preskript'
Fixed preskritar: changed paradigm 'a__adj' -> 'ar__vblex', stem -> 'preskrit'
Fixed prestar: changed paradigm 'a__adj' -> 'ar__vblex', stem -> 'prest'
Fixed pretextar: changed paradigm 'a__adj' -> 'ar__vblex', stem -> 'pretext'
Fixed preventar: changed paradigm 'a__adj' -> 'ar__vblex', stem -> 'prevent'
Fixed prezervar: changed paradigm 'a__adj' -> 'ar__vblex', stem -> 'prezerv'
Fixed prezidar: changed paradigm 'a__adj' -> 'ar__vblex', stem -> 'prezid'
Fixed prezuntar: changed paradigm 'a__adj' -> 'ar__vblex', stem -> 'prezunt'
Fixed priklar: changed paradigm 'a__adj' -> 'ar__vblex', stem -> 'prikl'
Fixed privacar: changed paradigm 'a__adj' -> 'ar__vblex', stem -> 'privac'
Fixed prizar: changed paradigm 'a__adj' -> 'ar__vblex', stem -> 'priz'
Fixed prizentar: changed paradigm 'a__adj' -> 'ar__vblex', stem -> 'prizent'
Fixed probar: changed paradigm 'a__adj' -> 'ar__vblex', stem -> 'prob'
Fixed procedar: changed paradigm 'a__adj' -> 'ar__vblex', stem -> 'proced'
Fixed procesar: changed paradigm 'a__adj' -> 'ar__vblex', stem -> 'proces'
Fixed procesionar: changed paradigm 'a__adj' -> 'ar__vblex', stem -> 'procesion'
Fixed produktar: changed paradigm 'a__adj' -> 'ar__vblex', stem -> 'produkt'
Fixed profanacar: changed paradigm 'a__adj' -> 'ar__vblex', stem -> 'profanac'
Fixed profesar: changed paradigm 'a__adj' -> 'ar__vblex', stem -> 'profes'
Fixed profitar: changed paradigm 'a__adj' -> 'ar__vblex', stem -> 'profit'
Fixed prognozar: changed paradigm 'a__adj' -> 'ar__vblex', stem -> 'prognoz'
Fixed progresar: changed paradigm 'a__adj' -> 'ar__vblex', stem -> 'progres'
Fixed projetar: changed paradigm 'a__adj' -> 'ar__vblex', stem -> 'projet'
Fixed proklamar: changed paradigm 'a__adj' -> 'ar__vblex', stem -> 'proklam'
Fixed prolongar: changed paradigm 'a__adj' -> 'ar__vblex', stem -> 'prolong'
Fixed promenar: changed paradigm 'a__adj' -> 'ar__vblex', stem -> 'promen'
Fixed promisar: changed paradigm 'a__adj' -> 'ar__vblex', stem -> 'promis'
Fixed promocar: changed paradigm 'a__adj' -> 'ar__vblex', stem -> 'promoc'
Fixed pronuncar: changed paradigm 'a__adj' -> 'ar__vblex', stem -> 'pronunc'
Fixed propagandar: changed paradigm 'a__adj' -> 'ar__vblex', stem -> 'propagand'
Fixed propagar: changed paradigm 'a__adj' -> 'ar__vblex', stem -> 'propag'
Fixed propozar: changed paradigm 'a__adj' -> 'ar__vblex', stem -> 'propoz'
Fixed propulsar: changed paradigm 'a__adj' -> 'ar__vblex', stem -> 'propuls'
Fixed prosperar: changed paradigm 'a__adj' -> 'ar__vblex', stem -> 'prosper'
Fixed prostitucado: changed lemma to 'prostitucada' (past participle), stem -> 'prostitucad'
Fixed prostracar: changed paradigm 'a__adj' -> 'ar__vblex', stem -> 'prostrac'
Fixed protektar: changed paradigm 'a__adj' -> 'ar__vblex', stem -> 'protekt'
Fixed protestar: changed paradigm 'a__adj' -> 'ar__vblex', stem -> 'protest'
Fixed provizar: changed paradigm 'a__adj' -> 'ar__vblex', stem -> 'proviz'
Fixed provokar: changed paradigm 'a__adj' -> 'ar__vblex', stem -> 'provok'
Fixed pruinar: changed paradigm 'a__adj' -> 'ar__vblex', stem -> 'pruin'
Fixed pruritar: changed paradigm 'a__adj' -> 'ar__vblex', stem -> 'prurit'
Fixed pruvar: changed paradigm 'a__adj' -> 'ar__vblex', stem -> 'pruv'
Fixed pudorar: changed paradigm 'a__adj' -> 'ar__vblex', stem -> 'pudor'
Fixed pumpar: changed paradigm 'a__adj' -> 'ar__vblex', stem -> 'pump'
Fixed puncar: changed paradigm 'a__adj' -> 'ar__vblex', stem -> 'punc'
Fixed puncionar: changed paradigm 'a__adj' -> 'ar__vblex', stem -> 'puncion'
Fixed punisar: changed paradigm 'a__adj' -> 'ar__vblex', stem -> 'punis'
Fixed punsar: changed paradigm 'a__adj' -> 'ar__vblex', stem -> 'puns'
Fixed purgar: changed paradigm 'a__adj' -> 'ar__vblex', stem -> 'purg'
Fixed putrar: changed paradigm 'a__adj' -> 'ar__vblex', stem -> 'putr'
Fixed qualifikar: changed paradigm 'a__adj' -> 'ar__vblex', stem -> 'qualifik'
Fixed querar: changed paradigm 'a__adj' -> 'ar__vblex', stem -> 'quer'
Fixed questar: changed paradigm 'a__adj' -> 'ar__vblex', stem -> 'quest'
Fixed questionar: changed paradigm 'a__adj' -> 'ar__vblex', stem -> 'question'
Fixed quirlar: changed paradigm 'a__adj' -> 'ar__vblex', stem -> 'quirl'
Fixed rabatar: changed paradigm 'a__adj' -> 'ar__vblex', stem -> 'rabat'
Fixed radiar: changed paradigm 'a__adj' -> 'ar__vblex', stem -> 'radi'
Fixed radiografar: changed paradigm 'a__adj' -> 'ar__vblex', stem -> 'radiograf'
Fixed radioskopar: changed paradigm 'a__adj' -> 'ar__vblex', stem -> 'radioskop'
Fixed radotar: changed paradigm 'a__adj' -> 'ar__vblex', stem -> 'radot'
Fixed rafinar: changed paradigm 'a__adj' -> 'ar__vblex', stem -> 'rafin'
Fixed rajuntar: changed paradigm 'a__adj' -> 'ar__vblex', stem -> 'rajunt'
Fixed rakar: changed paradigm 'a__adj' -> 'ar__vblex', stem -> 'rak'
Fixed rakontar: changed paradigm 'a__adj' -> 'ar__vblex', stem -> 'rakont'
Fixed rankorar: changed paradigm 'a__adj' -> 'ar__vblex', stem -> 'rankor'
Fixed rapecar: changed paradigm 'a__adj' -> 'ar__vblex', stem -> 'rapec'
Fixed raportar: changed paradigm 'a__adj' -> 'ar__vblex', stem -> 'raport'
Fixed raptar: changed paradigm 'a__adj' -> 'ar__vblex', stem -> 'rapt'
Fixed raspar: changed paradigm 'a__adj' -> 'ar__vblex', stem -> 'rasp'
Fixed rastar: changed paradigm 'a__adj' -> 'ar__vblex', stem -> 'rast'
Fixed ratifikar: changed paradigm 'a__adj' -> 'ar__vblex', stem -> 'ratifik'
Fixed ravisar: changed paradigm 'a__adj' -> 'ar__vblex', stem -> 'ravis'
Fixed razar: changed paradigm 'a__adj' -> 'ar__vblex', stem -> 'raz'
Fixed reaktar: changed paradigm 'a__adj' -> 'ar__vblex', stem -> 'reakt'
Fixed recensar: changed paradigm 'a__adj' -> 'ar__vblex', stem -> 'recens'
Fixed recevar: changed paradigm 'a__adj' -> 'ar__vblex', stem -> 'recev'
Fixed recidivar: changed paradigm 'a__adj' -> 'ar__vblex', stem -> 'recidiv'
Fixed recitar: changed paradigm 'a__adj' -> 'ar__vblex', stem -> 'recit'
Fixed redaktar: changed paradigm 'a__adj' -> 'ar__vblex', stem -> 'redakt'
Fixed redemtar: changed paradigm 'a__adj' -> 'ar__vblex', stem -> 'redemt'
Fixed reduktar: changed paradigm 'a__adj' -> 'ar__vblex', stem -> 'redukt'
Fixed referar: changed paradigm 'a__adj' -> 'ar__vblex', stem -> 'refer'
Fixed reflektar: changed paradigm 'a__adj' -> 'ar__vblex', stem -> 'reflekt'
Fixed refluxar: changed paradigm 'a__adj' -> 'ar__vblex', stem -> 'reflux'
Fixed reformar: changed paradigm 'a__adj' -> 'ar__vblex', stem -> 'reform'
Fixed refujar: changed paradigm 'a__adj' -> 'ar__vblex', stem -> 'refuj'
Fixed refutar: changed paradigm 'a__adj' -> 'ar__vblex', stem -> 'refut'
Fixed refuzar: changed paradigm 'a__adj' -> 'ar__vblex', stem -> 'refuz'
Fixed regalar: changed paradigm 'a__adj' -> 'ar__vblex', stem -> 'regal'
Fixed regardar: changed paradigm 'a__adj' -> 'ar__vblex', stem -> 'regard'
Fixed regenerar: changed paradigm 'a__adj' -> 'ar__vblex', stem -> 'regener'
Fixed registragar: changed paradigm 'a__adj' -> 'ar__vblex', stem -> 'registrag'
Fixed regnar: changed paradigm 'a__adj' -> 'ar__vblex', stem -> 'regn'
Fixed regresar: changed paradigm 'a__adj' -> 'ar__vblex', stem -> 'regres'
Fixed regretar: changed paradigm 'a__adj' -> 'ar__vblex', stem -> 'regret'
Fixed regular: changed paradigm 'a__adj' -> 'ar__vblex', stem -> 'regul'
Fixed rehabilitar: changed paradigm 'a__adj' -> 'ar__vblex', stem -> 'rehabilit'
Fixed rekapitular: changed paradigm 'a__adj' -> 'ar__vblex', stem -> 'rekapitul'
Fixed reklamacar: changed paradigm 'a__adj' -> 'ar__vblex', stem -> 'reklamac'
Fixed reklamar: changed paradigm 'a__adj' -> 'ar__vblex', stem -> 'reklam'
Fixed rekolecar: changed paradigm 'a__adj' -> 'ar__vblex', stem -> 'rekolec'
Fixed rekoliar: changed paradigm 'a__adj' -> 'ar__vblex', stem -> 'rekoli'
Fixed rekoltado: changed lemma to 'rekoltada' (past participle), stem -> 'rekoltad'
Fixed rekomendar: changed paradigm 'a__adj' -> 'ar__vblex', stem -> 'rekomend'
Fixed rekompensar: changed paradigm 'a__adj' -> 'ar__vblex', stem -> 'rekompens'
Fixed rekortar: changed paradigm 'a__adj' -> 'ar__vblex', stem -> 'rekort'
Fixed rekrutar: changed paradigm 'a__adj' -> 'ar__vblex', stem -> 'rekrut'
Fixed rektifikar: changed paradigm 'a__adj' -> 'ar__vblex', stem -> 'rektifik'
Fixed rekuperar: changed paradigm 'a__adj' -> 'ar__vblex', stem -> 'rekuper'
Fixed rekursar: changed paradigm 'a__adj' -> 'ar__vblex', stem -> 'rekurs'
Fixed relatar: changed paradigm 'a__adj' -> 'ar__vblex', stem -> 'relat'
Fixed relegar: changed paradigm 'a__adj' -> 'ar__vblex', stem -> 'releg'
Fixed remar: changed paradigm 'a__adj' -> 'ar__vblex', stem -> 'rem'
Fixed remarkar: changed paradigm 'a__adj' -> 'ar__vblex', stem -> 'remark'
Fixed remediar: changed paradigm 'a__adj' -> 'ar__vblex', stem -> 'remedi'
Fixed remisar: changed paradigm 'a__adj' -> 'ar__vblex', stem -> 'remis'
Fixed remonstrar: changed paradigm 'a__adj' -> 'ar__vblex', stem -> 'remonstr'
Fixed remorkar: changed paradigm 'a__adj' -> 'ar__vblex', stem -> 'remork'
Fixed remorsar: changed paradigm 'a__adj' -> 'ar__vblex', stem -> 'remors'
Fixed remplasar: changed paradigm 'a__adj' -> 'ar__vblex', stem -> 'remplas'
Fixed renegar: changed paradigm 'a__adj' -> 'ar__vblex', stem -> 'reneg'
Fixed renkontrar: changed paradigm 'a__adj' -> 'ar__vblex', stem -> 'renkontr'
Fixed renuncar: changed paradigm 'a__adj' -> 'ar__vblex', stem -> 'renunc'
Fixed renversar: changed paradigm 'a__adj' -> 'ar__vblex', stem -> 'renvers'
Fixed reparar: changed paradigm 'a__adj' -> 'ar__vblex', stem -> 'repar'
Fixed repartisar: changed paradigm 'a__adj' -> 'ar__vblex', stem -> 'repartis'
Fixed repasar: changed paradigm 'a__adj' -> 'ar__vblex', stem -> 'repas'
Fixed repastar: changed paradigm 'a__adj' -> 'ar__vblex', stem -> 'repast'
Fixed repentar: changed paradigm 'a__adj' -> 'ar__vblex', stem -> 'repent'
Fixed replikar: changed paradigm 'a__adj' -> 'ar__vblex', stem -> 'replik'
Fixed repozar: changed paradigm 'a__adj' -> 'ar__vblex', stem -> 'repoz'
Fixed represar: changed paradigm 'a__adj' -> 'ar__vblex', stem -> 'repres'
Fixed reprezalar: changed paradigm 'a__adj' -> 'ar__vblex', stem -> 'reprezal'
Fixed reprezentar: changed paradigm 'a__adj' -> 'ar__vblex', stem -> 'reprezent'
Fixed reprimandar: changed paradigm 'a__adj' -> 'ar__vblex', stem -> 'reprimand'
Fixed reprochar: changed paradigm 'a__adj' -> 'ar__vblex', stem -> 'reproch'
Fixed reptar: changed paradigm 'a__adj' -> 'ar__vblex', stem -> 'rept'
Fixed repugnar: changed paradigm 'a__adj' -> 'ar__vblex', stem -> 'repugn'
Fixed repulsar: changed paradigm 'a__adj' -> 'ar__vblex', stem -> 'repuls'
Fixed reputar: changed paradigm 'a__adj' -> 'ar__vblex', stem -> 'reput'
Fixed resonar: changed paradigm 'a__adj' -> 'ar__vblex', stem -> 'reson'
Fixed resortisar: changed paradigm 'a__adj' -> 'ar__vblex', stem -> 'resortis'
Fixed respektar: changed paradigm 'a__adj' -> 'ar__vblex', stem -> 'respekt'
Fixed respirar: changed paradigm 'a__adj' -> 'ar__vblex', stem -> 'respir'
Fixed respondar: changed paradigm 'a__adj' -> 'ar__vblex', stem -> 'respond'
Fixed restaurar: changed paradigm 'a__adj' -> 'ar__vblex', stem -> 'restaur'
Fixed restitucar: changed paradigm 'a__adj' -> 'ar__vblex', stem -> 'restituc'
Fixed restorar: changed paradigm 'a__adj' -> 'ar__vblex', stem -> 'restor'
Fixed restriktar: changed paradigm 'a__adj' -> 'ar__vblex', stem -> 'restrikt'
Fixed retenar: changed paradigm 'a__adj' -> 'ar__vblex', stem -> 'reten'
Fixed retraktar: changed paradigm 'a__adj' -> 'ar__vblex', stem -> 'retrakt'
Fixed retretar: changed paradigm 'a__adj' -> 'ar__vblex', stem -> 'retret'
Fixed retushar: changed paradigm 'a__adj' -> 'ar__vblex', stem -> 'retush'
Fixed revanchar: changed paradigm 'a__adj' -> 'ar__vblex', stem -> 'revanch'
Fixed revar: changed paradigm 'a__adj' -> 'ar__vblex', stem -> 'rev'
Fixed revelar: changed paradigm 'a__adj' -> 'ar__vblex', stem -> 'revel'
Fixed reverencar: changed paradigm 'a__adj' -> 'ar__vblex', stem -> 'reverenc'
Fixed revizar: changed paradigm 'a__adj' -> 'ar__vblex', stem -> 'reviz'
Fixed revokar: changed paradigm 'a__adj' -> 'ar__vblex', stem -> 'revok'
Fixed revoltar: changed paradigm 'a__adj' -> 'ar__vblex', stem -> 'revolt'
Fixed revolucionar: changed paradigm 'a__adj' -> 'ar__vblex', stem -> 'revolucion'
Fixed revuar: changed paradigm 'a__adj' -> 'ar__vblex', stem -> 'revu'
Fixed rezervar: changed paradigm 'a__adj' -> 'ar__vblex', stem -> 'rezerv'
Fixed rezignar: changed paradigm 'a__adj' -> 'ar__vblex', stem -> 'rezign'
Fixed rezistar: changed paradigm 'a__adj' -> 'ar__vblex', stem -> 'rezist'
Fixed rezolvar: changed paradigm 'a__adj' -> 'ar__vblex', stem -> 'rezolv'
Fixed rezonar: changed paradigm 'a__adj' -> 'ar__vblex', stem -> 'rezon'
Fixed rezultar: changed paradigm 'a__adj' -> 'ar__vblex', stem -> 'rezult'
Fixed rezumar: changed paradigm 'a__adj' -> 'ar__vblex', stem -> 'rezum'
Fixed rezurektar: changed paradigm 'a__adj' -> 'ar__vblex', stem -> 'rezurekt'
Fixed ridar: changed paradigm 'a__adj' -> 'ar__vblex', stem -> 'rid'
Fixed rikochar: changed paradigm 'a__adj' -> 'ar__vblex', stem -> 'rikoch'
Fixed rimborsar: changed paradigm 'a__adj' -> 'ar__vblex', stem -> 'rimbors'
Fixed rinforcar: changed paradigm 'a__adj' -> 'ar__vblex', stem -> 'rinforc'
Fixed rinsar: changed paradigm 'a__adj' -> 'ar__vblex', stem -> 'rins'
Fixed ripar: changed paradigm 'a__adj' -> 'ar__vblex', stem -> 'rip'
Fixed riskar: changed paradigm 'a__adj' -> 'ar__vblex', stem -> 'risk'
Fixed ristornar: changed paradigm 'a__adj' -> 'ar__vblex', stem -> 'ristorn'
Fixed rodar: changed paradigm 'a__adj' -> 'ar__vblex', stem -> 'rod'
Fixed ronkar: changed paradigm 'a__adj' -> 'ar__vblex', stem -> 'ronk'
Fixed rostar: changed paradigm 'a__adj' -> 'ar__vblex', stem -> 'rost'
Fixed rotacado: changed lemma to 'rotacada' (past participle), stem -> 'rotacad'
Fixed rotolar: changed paradigm 'a__adj' -> 'ar__vblex', stem -> 'rotol'
Fixed ruinar: changed paradigm 'a__adj' -> 'ar__vblex', stem -> 'ruin'
Fixed ruktar: changed paradigm 'a__adj' -> 'ar__vblex', stem -> 'rukt'
Fixed rukular: changed paradigm 'a__adj' -> 'ar__vblex', stem -> 'rukul'
Fixed rular: changed paradigm 'a__adj' -> 'ar__vblex', stem -> 'rul'
Fixed ruminar: changed paradigm 'a__adj' -> 'ar__vblex', stem -> 'rumin'
Fixed ruptar: changed paradigm 'a__adj' -> 'ar__vblex', stem -> 'rupt'
Fixed ruzar: changed paradigm 'a__adj' -> 'ar__vblex', stem -> 'ruz'
Fixed saciar: changed paradigm 'a__adj' -> 'ar__vblex', stem -> 'saci'
Fixed sakrifikar: changed paradigm 'a__adj' -> 'ar__vblex', stem -> 'sakrifik'
Fixed sakrilejar: changed paradigm 'a__adj' -> 'ar__vblex', stem -> 'sakrilej'
Fixed salariar: changed paradigm 'a__adj' -> 'ar__vblex', stem -> 'salari'
Fixed saldar: changed paradigm 'a__adj' -> 'ar__vblex', stem -> 'sald'
Fixed saliar: changed paradigm 'a__adj' -> 'ar__vblex', stem -> 'sali'
Fixed saltar: changed paradigm 'a__adj' -> 'ar__vblex', stem -> 'salt'
Fixed salvar: changed paradigm 'a__adj' -> 'ar__vblex', stem -> 'salv'
Fixed sancionar: changed paradigm 'a__adj' -> 'ar__vblex', stem -> 'sancion'
Fixed sarklar: changed paradigm 'a__adj' -> 'ar__vblex', stem -> 'sarkl'
Fixed satisfacar: changed paradigm 'a__adj' -> 'ar__vblex', stem -> 'satisfac'
Fixed saturar: changed paradigm 'a__adj' -> 'ar__vblex', stem -> 'satur'
Fixed savar: changed paradigm 'a__adj' -> 'ar__vblex', stem -> 'sav'
Fixed savurar: changed paradigm 'a__adj' -> 'ar__vblex', stem -> 'savur'
Fixed seduktar: changed paradigm 'a__adj' -> 'ar__vblex', stem -> 'sedukt'
Fixed segar: changed paradigm 'a__adj' -> 'ar__vblex', stem -> 'seg'
Fixed sekar: changed paradigm 'a__adj' -> 'ar__vblex', stem -> 'sek'
Fixed sekondar: changed paradigm 'a__adj' -> 'ar__vblex', stem -> 'sekond'
Fixed sekrecar: changed paradigm 'a__adj' -> 'ar__vblex', stem -> 'sekrec'
Fixed selektar: changed paradigm 'a__adj' -> 'ar__vblex', stem -> 'selekt'
Fixed semar: changed paradigm 'a__adj' -> 'ar__vblex', stem -> 'sem'
Fixed semblar: changed paradigm 'a__adj' -> 'ar__vblex', stem -> 'sembl'
Fixed sendar: changed paradigm 'a__adj' -> 'ar__vblex', stem -> 'send'
Fixed sentar: changed paradigm 'a__adj' -> 'ar__vblex', stem -> 'sent'
Fixed separar: changed paradigm 'a__adj' -> 'ar__vblex', stem -> 'separ'
Fixed sepultar: changed paradigm 'a__adj' -> 'ar__vblex', stem -> 'sepult'
Fixed serchar: changed paradigm 'a__adj' -> 'ar__vblex', stem -> 'serch'
Fixed servado: changed lemma to 'servada' (past participle), stem -> 'servad'
Fixed sesgar: changed paradigm 'a__adj' -> 'ar__vblex', stem -> 'sesg'
Fixed shampunar: changed paradigm 'a__adj' -> 'ar__vblex', stem -> 'shampun'
Fixed shancelar: changed paradigm 'a__adj' -> 'ar__vblex', stem -> 'shancel'
Fixed shikanar: changed paradigm 'a__adj' -> 'ar__vblex', stem -> 'shikan'
Fixed shirmar: changed paradigm 'a__adj' -> 'ar__vblex', stem -> 'shirm'
Fixed shokar: changed paradigm 'a__adj' -> 'ar__vblex', stem -> 'shok'
Fixed shovar: changed paradigm 'a__adj' -> 'ar__vblex', stem -> 'shov'
Fixed shovelagar: changed paradigm 'a__adj' -> 'ar__vblex', stem -> 'shovelag'
Fixed sidar: changed paradigm 'a__adj' -> 'ar__vblex', stem -> 'sid'
Fixed siejar: changed paradigm 'a__adj' -> 'ar__vblex', stem -> 'siej'
Fixed siflar: changed paradigm 'a__adj' -> 'ar__vblex', stem -> 'sifl'
Fixed siglar: changed paradigm 'a__adj' -> 'ar__vblex', stem -> 'sigl'
Fixed signalar: changed paradigm 'a__adj' -> 'ar__vblex', stem -> 'signal'
Fixed signatar: changed paradigm 'a__adj' -> 'ar__vblex', stem -> 'signat'
Fixed silencar: changed paradigm 'a__adj' -> 'ar__vblex', stem -> 'silenc'
Fixed simpatiar: changed paradigm 'a__adj' -> 'ar__vblex', stem -> 'simpati'
Fixed simulado: changed lemma to 'simulada' (past participle), stem -> 'simulad'
Fixed singlutar: changed paradigm 'a__adj' -> 'ar__vblex', stem -> 'singlut'
Fixed sinkar: changed paradigm 'a__adj' -> 'ar__vblex', stem -> 'sink'
Fixed sinkopar: changed paradigm 'a__adj' -> 'ar__vblex', stem -> 'sinkop'
Fixed sisar: changed paradigm 'a__adj' -> 'ar__vblex', stem -> 'sis'
Fixed situar: changed paradigm 'a__adj' -> 'ar__vblex', stem -> 'situ'
Fixed sizar: changed paradigm 'a__adj' -> 'ar__vblex', stem -> 'siz'
Fixed skanar: changed paradigm 'a__adj' -> 'ar__vblex', stem -> 'skan'
Fixed skandalar: changed paradigm 'a__adj' -> 'ar__vblex', stem -> 'skandal'
Fixed skandar: changed paradigm 'a__adj' -> 'ar__vblex', stem -> 'skand'
Fixed skermar: changed paradigm 'a__adj' -> 'ar__vblex', stem -> 'skerm'
Fixed sketar: changed paradigm 'a__adj' -> 'ar__vblex', stem -> 'sket'
Fixed skisar: changed paradigm 'a__adj' -> 'ar__vblex', stem -> 'skis'
Fixed skrachar: changed paradigm 'a__adj' -> 'ar__vblex', stem -> 'skrach'
Fixed skrapar: changed paradigm 'a__adj' -> 'ar__vblex', stem -> 'skrap'
Fixed skriptar: changed paradigm 'a__adj' -> 'ar__vblex', stem -> 'skript'
Fixed skultar: changed paradigm 'a__adj' -> 'ar__vblex', stem -> 'skult'
Fixed skurar: changed paradigm 'a__adj' -> 'ar__vblex', stem -> 'skur'
Fixed smerilagar: changed paradigm 'a__adj' -> 'ar__vblex', stem -> 'smerilag'
Fixed snapar: changed paradigm 'a__adj' -> 'ar__vblex', stem -> 'snap'
Fixed sniflar: changed paradigm 'a__adj' -> 'ar__vblex', stem -> 'snifl'
Fixed snortar: changed paradigm 'a__adj' -> 'ar__vblex', stem -> 'snort'
Fixed sodomiar: changed paradigm 'a__adj' -> 'ar__vblex', stem -> 'sodomi'
Fixed sokursado: changed lemma to 'sokursada' (past participle), stem -> 'sokursad'
Fixed soldar: changed paradigm 'a__adj' -> 'ar__vblex', stem -> 'sold'
Fixed solicitar: changed paradigm 'a__adj' -> 'ar__vblex', stem -> 'solicit'
Fixed solvar: changed paradigm 'a__adj' -> 'ar__vblex', stem -> 'solv'
Fixed somnolar: changed paradigm 'a__adj' -> 'ar__vblex', stem -> 'somnol'
Fixed sonar: changed paradigm 'a__adj' -> 'ar__vblex', stem -> 'son'
Fixed sondar: changed paradigm 'a__adj' -> 'ar__vblex', stem -> 'sond'
Fixed sonjar: changed paradigm 'a__adj' -> 'ar__vblex', stem -> 'sonj'
Fixed sorcadar: changed paradigm 'a__adj' -> 'ar__vblex', stem -> 'sorcad'
Fixed sorgar: changed paradigm 'a__adj' -> 'ar__vblex', stem -> 'sorg'
Fixed sospirar: changed paradigm 'a__adj' -> 'ar__vblex', stem -> 'sospir'
Fixed spadagar: changed paradigm 'a__adj' -> 'ar__vblex', stem -> 'spadag'
Fixed sparar: changed paradigm 'a__adj' -> 'ar__vblex', stem -> 'spar'
Fixed spektar: changed paradigm 'a__adj' -> 'ar__vblex', stem -> 'spekt'
Fixed spekular: changed paradigm 'a__adj' -> 'ar__vblex', stem -> 'spekul'
Fixed spensar: changed paradigm 'a__adj' -> 'ar__vblex', stem -> 'spens'
Fixed spionar: changed paradigm 'a__adj' -> 'ar__vblex', stem -> 'spion'
Fixed splinar: changed paradigm 'a__adj' -> 'ar__vblex', stem -> 'splin'
Fixed splisar: changed paradigm 'a__adj' -> 'ar__vblex', stem -> 'splis'
Fixed spoliadar: changed paradigm 'a__adj' -> 'ar__vblex', stem -> 'spoliad'
Fixed sponjagar: changed paradigm 'a__adj' -> 'ar__vblex', stem -> 'sponjag'
Fixed spricar: changed paradigm 'a__adj' -> 'ar__vblex', stem -> 'spric'
Fixed springar: changed paradigm 'a__adj' -> 'ar__vblex', stem -> 'spring'
Fixed spular: changed paradigm 'a__adj' -> 'ar__vblex', stem -> 'spul'
Fixed sputar: changed paradigm 'a__adj' -> 'ar__vblex', stem -> 'sput'
Fixed squatar: changed paradigm 'a__adj' -> 'ar__vblex', stem -> 'squat'
Fixed stacar: changed paradigm 'a__adj' -> 'ar__vblex', stem -> 'stac'
Fixed stagnar: changed paradigm 'a__adj' -> 'ar__vblex', stem -> 'stagn'
Fixed stampar: changed paradigm 'a__adj' -> 'ar__vblex', stem -> 'stamp'
Fixed standar: changed paradigm 'a__adj' -> 'ar__vblex', stem -> 'stand'
Fixed starchar: changed paradigm 'a__adj' -> 'ar__vblex', stem -> 'starch'
Fixed startar: changed paradigm 'a__adj' -> 'ar__vblex', stem -> 'start'
Fixed stebar: changed paradigm 'a__adj' -> 'ar__vblex', stem -> 'steb'
Fixed stekar: changed paradigm 'a__adj' -> 'ar__vblex', stem -> 'stek'
Fixed stenografar: changed paradigm 'a__adj' -> 'ar__vblex', stem -> 'stenograf'
Fixed sternar: changed paradigm 'a__adj' -> 'ar__vblex', stem -> 'stern'
Fixed sternutar: changed paradigm 'a__adj' -> 'ar__vblex', stem -> 'sternut'
Fixed stertorar: changed paradigm 'a__adj' -> 'ar__vblex', stem -> 'stertor'
Fixed stimular: changed paradigm 'a__adj' -> 'ar__vblex', stem -> 'stimul'
Fixed stipular: changed paradigm 'a__adj' -> 'ar__vblex', stem -> 'stipul'
Fixed stopar: changed paradigm 'a__adj' -> 'ar__vblex', stem -> 'stop'
Fixed stoterar: changed paradigm 'a__adj' -> 'ar__vblex', stem -> 'stoter'
Fixed strandar: changed paradigm 'a__adj' -> 'ar__vblex', stem -> 'strand'
Fixed strangular: changed paradigm 'a__adj' -> 'ar__vblex', stem -> 'strangul'
Fixed strikar: changed paradigm 'a__adj' -> 'ar__vblex', stem -> 'strik'
Fixed studiar: changed paradigm 'a__adj' -> 'ar__vblex', stem -> 'studi'
Fixed stufar: changed paradigm 'a__adj' -> 'ar__vblex', stem -> 'stuf'
Fixed stuntar: changed paradigm 'a__adj' -> 'ar__vblex', stem -> 'stunt'
Fixed subisar: changed paradigm 'a__adj' -> 'ar__vblex', stem -> 'subis'
Fixed submersar: changed paradigm 'a__adj' -> 'ar__vblex', stem -> 'submers'
Fixed submisar: changed paradigm 'a__adj' -> 'ar__vblex', stem -> 'submis'
Fixed subordinar: changed paradigm 'a__adj' -> 'ar__vblex', stem -> 'subordin'
Fixed subornar: changed paradigm 'a__adj' -> 'ar__vblex', stem -> 'suborn'
Fixed subreptar: changed paradigm 'a__adj' -> 'ar__vblex', stem -> 'subrept'
Fixed substitucar: changed paradigm 'a__adj' -> 'ar__vblex', stem -> 'substituc'
Fixed subvencionar: changed paradigm 'a__adj' -> 'ar__vblex', stem -> 'subvencion'
Fixed subversar: changed paradigm 'a__adj' -> 'ar__vblex', stem -> 'subvers'
Fixed sucedar: changed paradigm 'a__adj' -> 'ar__vblex', stem -> 'suced'
Fixed sucesar: changed paradigm 'a__adj' -> 'ar__vblex', stem -> 'suces'
Fixed suciar: changed paradigm 'a__adj' -> 'ar__vblex', stem -> 'suci'
Fixed suficar: changed paradigm 'a__adj' -> 'ar__vblex', stem -> 'sufic'
Fixed suflar: changed paradigm 'a__adj' -> 'ar__vblex', stem -> 'sufl'
Fixed sufokar: changed paradigm 'a__adj' -> 'ar__vblex', stem -> 'sufok'
Fixed sufrado: changed lemma to 'sufrada' (past participle), stem -> 'sufrad'
Fixed sugar: changed paradigm 'a__adj' -> 'ar__vblex', stem -> 'sug'
Fixed sugestar: changed paradigm 'a__adj' -> 'ar__vblex', stem -> 'sugest'
Fixed sukombar: changed paradigm 'a__adj' -> 'ar__vblex', stem -> 'sukomb'
Fixed sukusar: changed paradigm 'a__adj' -> 'ar__vblex', stem -> 'sukus'
Fixed sumnar: changed paradigm 'a__adj' -> 'ar__vblex', stem -> 'sumn'
Fixed supear: changed paradigm 'a__adj' -> 'ar__vblex', stem -> 'supe'
Fixed suplantar: changed paradigm 'a__adj' -> 'ar__vblex', stem -> 'suplant'
Fixed suplear: changed paradigm 'a__adj' -> 'ar__vblex', stem -> 'suple'
Fixed suplikar: changed paradigm 'a__adj' -> 'ar__vblex', stem -> 'suplik'
Fixed suportar: changed paradigm 'a__adj' -> 'ar__vblex', stem -> 'suport'
Fixed supozar: changed paradigm 'a__adj' -> 'ar__vblex', stem -> 'supoz'
Fixed supresar: changed paradigm 'a__adj' -> 'ar__vblex', stem -> 'supres'
Fixed surfar: changed paradigm 'a__adj' -> 'ar__vblex', stem -> 'surf'
Fixed surprizar: changed paradigm 'a__adj' -> 'ar__vblex', stem -> 'surpriz'
Fixed suskriptar: changed paradigm 'a__adj' -> 'ar__vblex', stem -> 'suskript'
Fixed suspektar: changed paradigm 'a__adj' -> 'ar__vblex', stem -> 'suspekt'
Fixed suspendar: changed paradigm 'a__adj' -> 'ar__vblex', stem -> 'suspend'
Fixed suspensar: changed paradigm 'a__adj' -> 'ar__vblex', stem -> 'suspens'
Fixed sustenar: changed paradigm 'a__adj' -> 'ar__vblex', stem -> 'susten'
Fixed sustracionar: changed paradigm 'a__adj' -> 'ar__vblex', stem -> 'sustracion'
Fixed sustraktar: changed paradigm 'a__adj' -> 'ar__vblex', stem -> 'sustrakt'
Fixed susurar: changed paradigm 'a__adj' -> 'ar__vblex', stem -> 'susur'
Fixed sutar: changed paradigm 'a__adj' -> 'ar__vblex', stem -> 'sut'
Fixed taxado: changed lemma to 'taxada' (past participle), stem -> 'taxad'
Fixed timar: changed paradigm 'a__adj' -> 'ar__vblex', stem -> 'tim'
Fixed tondrar: changed paradigm 'a__adj' -> 'ar__vblex', stem -> 'tondr'
Fixed tormentar: changed paradigm 'a__adj' -> 'ar__vblex', stem -> 'torment'
Fixed trahizar: changed paradigm 'a__adj' -> 'ar__vblex', stem -> 'trahiz'
Fixed traktado: changed lemma to 'traktada' (past participle), stem -> 'traktad'
Fixed transfigurar: changed paradigm 'a__adj' -> 'ar__vblex', stem -> 'transfigur'
Fixed transportar: changed paradigm 'a__adj' -> 'ar__vblex', stem -> 'transport'
Fixed tribular: changed paradigm 'a__adj' -> 'ar__vblex', stem -> 'tribul'
Fixed triturar: changed paradigm 'a__adj' -> 'ar__vblex', stem -> 'tritur'
Fixed trompar: changed paradigm 'a__adj' -> 'ar__vblex', stem -> 'tromp'
Fixed trotado: changed lemma to 'trotada' (past participle), stem -> 'trotad'
Fixed tusar: changed paradigm 'a__adj' -> 'ar__vblex', stem -> 'tus'
Fixed ulular: changed paradigm 'a__adj' -> 'ar__vblex', stem -> 'ulul'
Fixed uncionar: changed paradigm 'a__adj' -> 'ar__vblex', stem -> 'uncion'
Fixed unionar: changed paradigm 'a__adj' -> 'ar__vblex', stem -> 'union'
Fixed urdar: changed paradigm 'a__adj' -> 'ar__vblex', stem -> 'urd'
Fixed uzufruktar: changed paradigm 'a__adj' -> 'ar__vblex', stem -> 'uzufrukt'
Fixed uzurar: changed paradigm 'a__adj' -> 'ar__vblex', stem -> 'uzur'
Fixed uzurpar: changed paradigm 'a__adj' -> 'ar__vblex', stem -> 'uzurp'
Fixed vacilar: changed paradigm 'a__adj' -> 'ar__vblex', stem -> 'vacil'
Fixed vagar: changed paradigm 'a__adj' -> 'ar__vblex', stem -> 'vag'
Fixed vajisar: changed paradigm 'a__adj' -> 'ar__vblex', stem -> 'vajis'
Fixed vakancar: changed paradigm 'a__adj' -> 'ar__vblex', stem -> 'vakanc'
Fixed vakar: changed paradigm 'a__adj' -> 'ar__vblex', stem -> 'vak'
Fixed valorar: changed paradigm 'a__adj' -> 'ar__vblex', stem -> 'valor'
Fixed valsar: changed paradigm 'a__adj' -> 'ar__vblex', stem -> 'vals'
Fixed variar: changed paradigm 'a__adj' -> 'ar__vblex', stem -> 'vari'
Fixed varsar: changed paradigm 'a__adj' -> 'ar__vblex', stem -> 'vars'
Fixed vartar: changed paradigm 'a__adj' -> 'ar__vblex', stem -> 'vart'
Fixed vejetarar: changed paradigm 'a__adj' -> 'ar__vblex', stem -> 'vejetar'
Fixed vekar: changed paradigm 'a__adj' -> 'ar__vblex', stem -> 'vek'
Fixed venar: changed paradigm 'a__adj' -> 'ar__vblex', stem -> 'ven'
Fixed vendar: changed paradigm 'a__adj' -> 'ar__vblex', stem -> 'vend'
Fixed veneracar: changed paradigm 'a__adj' -> 'ar__vblex', stem -> 'venerac'
Fixed venjar: changed paradigm 'a__adj' -> 'ar__vblex', stem -> 'venj'
Fixed ventar: changed paradigm 'a__adj' -> 'ar__vblex', stem -> 'vent'
Fixed ventilar: changed paradigm 'a__adj' -> 'ar__vblex', stem -> 'ventil'
Fixed verifikar: changed paradigm 'a__adj' -> 'ar__vblex', stem -> 'verifik'
Fixed vertijar: changed paradigm 'a__adj' -> 'ar__vblex', stem -> 'vertij'
Fixed vetar: changed paradigm 'a__adj' -> 'ar__vblex', stem -> 'vet'
Fixed vexar: changed paradigm 'a__adj' -> 'ar__vblex', stem -> 'vex'
Fixed vibrar: changed paradigm 'a__adj' -> 'ar__vblex', stem -> 'vibr'
Fixed vidar: changed paradigm 'a__adj' -> 'ar__vblex', stem -> 'vid'
Fixed vigilar: changed paradigm 'a__adj' -> 'ar__vblex', stem -> 'vigil'
Fixed vindar: changed paradigm 'a__adj' -> 'ar__vblex', stem -> 'vind'
Fixed vinkar: changed paradigm 'a__adj' -> 'ar__vblex', stem -> 'vink'
Fixed violacar: changed paradigm 'a__adj' -> 'ar__vblex', stem -> 'violac'
Fixed violentar: changed paradigm 'a__adj' -> 'ar__vblex', stem -> 'violent'
Fixed visar: changed paradigm 'a__adj' -> 'ar__vblex', stem -> 'vis'
Fixed vishar: changed paradigm 'a__adj' -> 'ar__vblex', stem -> 'vish'
Fixed vistar: changed paradigm 'a__adj' -> 'ar__vblex', stem -> 'vist'
Fixed vivar: changed paradigm 'a__adj' -> 'ar__vblex', stem -> 'viv'
Fixed vizar: changed paradigm 'a__adj' -> 'ar__vblex', stem -> 'viz'
Fixed volar: changed paradigm 'a__adj' -> 'ar__vblex', stem -> 'vol'
Fixed voltijar: changed paradigm 'a__adj' -> 'ar__vblex', stem -> 'voltij'
Fixed voluntar: changed paradigm 'a__adj' -> 'ar__vblex', stem -> 'volunt'
Fixed vomar: changed paradigm 'a__adj' -> 'ar__vblex', stem -> 'vom'
Fixed vorticar: changed paradigm 'a__adj' -> 'ar__vblex', stem -> 'vortic'
Fixed votar: changed paradigm 'a__adj' -> 'ar__vblex', stem -> 'vot'
Fixed vovar: changed paradigm 'a__adj' -> 'ar__vblex', stem -> 'vov'
Fixed voyajar: changed paradigm 'a__adj' -> 'ar__vblex', stem -> 'voyaj'
Fixed vundar: changed paradigm 'a__adj' -> 'ar__vblex', stem -> 'vund'
Fixed weldar: changed paradigm 'a__adj' -> 'ar__vblex', stem -> 'weld'
Fixed xilografar: changed paradigm 'a__adj' -> 'ar__vblex', stem -> 'xilograf'
Fixed yodlar: changed paradigm 'a__adj' -> 'ar__vblex', stem -> 'yodl'
Fixed zelar: changed paradigm 'a__adj' -> 'ar__vblex', stem -> 'zel'
Fixed zigzagar: changed paradigm 'a__adj' -> 'ar__vblex', stem -> 'zigzag'
Fixed zumar: changed paradigm 'a__adj' -> 'ar__vblex', stem -> 'zum'
Fixed abadeyo: changed lemma to 'abadeye', paradigm stays 'e__adv', stem -> 'abadey'
Fixed abeleyo: changed lemma to 'abeleye', paradigm stays 'e__adv', stem -> 'abeley'
Fixed absenteso: changed lemma to 'absentese', paradigm stays 'e__adv', stem -> 'absentes'
Fixed acendebla: changed lemma to 'acendeble', paradigm stays 'e__adv', stem -> 'acendebl'
Fixed acensebla: changed lemma to 'acenseble', paradigm stays 'e__adv', stem -> 'acensebl'
Fixed afektacema: changed lemma to 'afektaceme', paradigm stays 'e__adv', stem -> 'afektacem'
Fixed agenterio: changed lemma to 'agenterie', paradigm stays 'e__adv', stem -> 'agenteri'
Fixed ajornebla: changed lemma to 'ajorneble', paradigm stays 'e__adv', stem -> 'ajornebl'
Fixed amikeso: changed lemma to 'amikese', paradigm stays 'e__adv', stem -> 'amikes'
Fixed anestezieso: changed lemma to 'anesteziese', paradigm stays 'e__adv', stem -> 'anestezies'
Fixed aprentiseso: changed lemma to 'aprentisese', paradigm stays 'e__adv', stem -> 'aprentises'
Fixed arkero: changed lemma to 'arkere', paradigm stays 'e__adv', stem -> 'arker'
Fixed austereso: changed lemma to 'austerese', paradigm stays 'e__adv', stem -> 'austeres'
Fixed babilemo: changed lemma to 'babileme', paradigm stays 'e__adv', stem -> 'babilem'
Fixed bakerio: changed lemma to 'bakerie', paradigm stays 'e__adv', stem -> 'bakeri'
Fixed baloneto: changed lemma to 'balonete', paradigm stays 'e__adv', stem -> 'balonet'
Fixed beleso: changed lemma to 'belese', paradigm stays 'e__adv', stem -> 'beles'
Fixed bigameso: changed lemma to 'bigamese', paradigm stays 'e__adv', stem -> 'bigames'
Fixed blindeso: changed lemma to 'blindese', paradigm stays 'e__adv', stem -> 'blindes'
Fixed bonega: changed lemma to 'bonege', paradigm stays 'e__adv', stem -> 'boneg'
Fixed brulebla: changed lemma to 'bruleble', paradigm stays 'e__adv', stem -> 'brulebl'
Fixed bucherio: changed lemma to 'bucherie', paradigm stays 'e__adv', stem -> 'bucheri'
Fixed buleto: changed lemma to 'bulete', paradigm stays 'e__adv', stem -> 'bulet'
Fixed buxeto: changed lemma to 'buxete', paradigm stays 'e__adv', stem -> 'buxet'
Fixed cedebla: changed lemma to 'cedeble', paradigm stays 'e__adv', stem -> 'cedebl'
Fixed celema: changed lemma to 'celeme', paradigm stays 'e__adv', stem -> 'celem'
Fixed ceneyo: changed lemma to 'ceneye', paradigm stays 'e__adv', stem -> 'ceney'
Fixed centesma: changed lemma to 'centesme', paradigm stays 'e__adv', stem -> 'centesm'
Fixed cerizea: changed lemma to 'cerizee', paradigm stays 'e__adv', stem -> 'cerize'
Fixed chambreto: changed lemma to 'chambrete', paradigm stays 'e__adv', stem -> 'chambret'
Fixed chamea: changed lemma to 'chamee', paradigm stays 'e__adv', stem -> 'chame'
Fixed championeso: changed lemma to 'championese', paradigm stays 'e__adv', stem -> 'championes'
Fixed chanjebla: changed lemma to 'chanjeble', paradigm stays 'e__adv', stem -> 'chanjebl'
Fixed charedo: changed lemma to 'charede', paradigm stays 'e__adv', stem -> 'chared'
Fixed chasteso: changed lemma to 'chastese', paradigm stays 'e__adv', stem -> 'chastes'
Fixed chefeso: changed lemma to 'chefese', paradigm stays 'e__adv', stem -> 'chefes'
Fixed chikeso: changed lemma to 'chikese', paradigm stays 'e__adv', stem -> 'chikes'
Fixed chomeso: changed lemma to 'chomese', paradigm stays 'e__adv', stem -> 'chomes'
Fixed ciboleto: changed lemma to 'cibolete', paradigm stays 'e__adv', stem -> 'cibolet'
Fixed cirkulero: changed lemma to 'cirkulere', paradigm stays 'e__adv', stem -> 'cirkuler'
Fixed debochema: changed lemma to 'debocheme', paradigm stays 'e__adv', stem -> 'debochem'
Fixed dejuneto: changed lemma to 'dejunete', paradigm stays 'e__adv', stem -> 'dejunet'
Fixed dementeso: changed lemma to 'dementese', paradigm stays 'e__adv', stem -> 'dementes'
Fixed dentego: changed lemma to 'dentege', paradigm stays 'e__adv', stem -> 'denteg'
Fixed depozeyo: changed lemma to 'depozeye', paradigm stays 'e__adv', stem -> 'depozey'
Fixed diableto: changed lemma to 'diablete', paradigm stays 'e__adv', stem -> 'diablet'
Fixed digneso: changed lemma to 'dignese', paradigm stays 'e__adv', stem -> 'dignes'
Fixed diktatoreso: changed lemma to 'diktatorese', paradigm stays 'e__adv', stem -> 'diktatores'
Fixed disponebla: changed lemma to 'disponeble', paradigm stays 'e__adv', stem -> 'disponebl'
Fixed doganeyo: changed lemma to 'doganeye', paradigm stays 'e__adv', stem -> 'doganey'
Fixed doktoreso: changed lemma to 'doktorese', paradigm stays 'e__adv', stem -> 'doktores'
Fixed dometo: changed lemma to 'domete', paradigm stays 'e__adv', stem -> 'domet'
Fixed duesma: changed lemma to 'duesme', paradigm stays 'e__adv', stem -> 'duesm'
Fixed eloquenteso: changed lemma to 'eloquentese', paradigm stays 'e__adv', stem -> 'eloquentes'
Fixed eskrokero: changed lemma to 'eskrokere', paradigm stays 'e__adv', stem -> 'eskroker'
Fixed explorero: changed lemma to 'explorere', paradigm stays 'e__adv', stem -> 'explorer'
Fixed fabrikerio: changed lemma to 'fabrikerie', paradigm stays 'e__adv', stem -> 'fabrikeri'
Fixed fiereso: changed lemma to 'fierese', paradigm stays 'e__adv', stem -> 'fieres'
Fixed frateso: changed lemma to 'fratese', paradigm stays 'e__adv', stem -> 'frates'
Fixed frequeso: changed lemma to 'frequese', paradigm stays 'e__adv', stem -> 'freques'
Fixed frugaleso: changed lemma to 'frugalese', paradigm stays 'e__adv', stem -> 'frugales'
Fixed glasedo: changed lemma to 'glasede', paradigm stays 'e__adv', stem -> 'glased'
Fixed grandega: changed lemma to 'grandege', paradigm stays 'e__adv', stem -> 'grandeg'
Fixed gravideso: changed lemma to 'gravidese', paradigm stays 'e__adv', stem -> 'gravides'
Fixed heterosexualeso: changed lemma to 'heterosexualese', paradigm stays 'e__adv', stem -> 'heterosexuales'
Fixed historiero: changed lemma to 'historiere', paradigm stays 'e__adv', stem -> 'historier'
Fixed homeosexualeso: changed lemma to 'homeosexualese', paradigm stays 'e__adv', stem -> 'homeosexuales'
Fixed indulgema: changed lemma to 'indulgeme', paradigm stays 'e__adv', stem -> 'indulgem'
Fixed inerteso: changed lemma to 'inertese', paradigm stays 'e__adv', stem -> 'inertes'
Fixed inflamebla: changed lemma to 'inflameble', paradigm stays 'e__adv', stem -> 'inflamebl'
Fixed inspektero: changed lemma to 'inspektere', paradigm stays 'e__adv', stem -> 'inspekter'
Fixed instruktero: changed lemma to 'instruktere', paradigm stays 'e__adv', stem -> 'instrukter'
Fixed integreso: changed lemma to 'integrese', paradigm stays 'e__adv', stem -> 'integres'
Fixed inteligenteso: changed lemma to 'inteligentese', paradigm stays 'e__adv', stem -> 'inteligentes'
Fixed iracema: changed lemma to 'iraceme', paradigm stays 'e__adv', stem -> 'iracem'
Fixed jaketo: changed lemma to 'jakete', paradigm stays 'e__adv', stem -> 'jaket'
Fixed jaluzeso: changed lemma to 'jaluzese', paradigm stays 'e__adv', stem -> 'jaluzes'
Fixed judiciero: changed lemma to 'judiciere', paradigm stays 'e__adv', stem -> 'judicier'
Fixed kafeerio: changed lemma to 'kafeerie', paradigm stays 'e__adv', stem -> 'kafeeri'
Fixed kalzeto: changed lemma to 'kalzete', paradigm stays 'e__adv', stem -> 'kalzet'
Fixed kanonizeso: changed lemma to 'kanonizese', paradigm stays 'e__adv', stem -> 'kanonizes'
Fixed kombusteblajo: changed lemma to 'kombusteblaje', paradigm stays 'e__adv', stem -> 'kombusteblaj'
Fixed komplezema: changed lemma to 'komplezeme', paradigm stays 'e__adv', stem -> 'komplezem'
Fixed komputero: changed lemma to 'komputere', paradigm stays 'e__adv', stem -> 'komputer'
Fixed konsilero: changed lemma to 'konsilere', paradigm stays 'e__adv', stem -> 'konsiler'
Fixed konsumero: changed lemma to 'konsumere', paradigm stays 'e__adv', stem -> 'konsumer'
Fixed koqueyo: changed lemma to 'koqueye', paradigm stays 'e__adv', stem -> 'koquey'
Fixed kunikleyo: changed lemma to 'kunikleye', paradigm stays 'e__adv', stem -> 'kunikley'
Fixed kuseneto: changed lemma to 'kusenete', paradigm stays 'e__adv', stem -> 'kusenet'
Fixed lanceto: changed lemma to 'lancete', paradigm stays 'e__adv', stem -> 'lancet'
Fixed langeto: changed lemma to 'langete', paradigm stays 'e__adv', stem -> 'langet'
Fixed ledeso: changed lemma to 'ledese', paradigm stays 'e__adv', stem -> 'ledes'
Fixed libereso: changed lemma to 'liberese', paradigm stays 'e__adv', stem -> 'liberes'
Fixed lojeyo: changed lemma to 'lojeye', paradigm stays 'e__adv', stem -> 'lojey'
Fixed loyaleso: changed lemma to 'loyalese', paradigm stays 'e__adv', stem -> 'loyales'
Fixed ludero: changed lemma to 'ludere', paradigm stays 'e__adv', stem -> 'luder'
Fixed maladeso: changed lemma to 'maladese', paradigm stays 'e__adv', stem -> 'malades'
Fixed manuedo: changed lemma to 'manuede', paradigm stays 'e__adv', stem -> 'manued'
Fixed margriteto: changed lemma to 'margritete', paradigm stays 'e__adv', stem -> 'margritet'
Fixed miopeso: changed lemma to 'miopese', paradigm stays 'e__adv', stem -> 'miopes'
Fixed monteto: changed lemma to 'montete', paradigm stays 'e__adv', stem -> 'montet'
Fixed mutacebla: changed lemma to 'mutaceble', paradigm stays 'e__adv', stem -> 'mutacebl'
Fixed obediema: changed lemma to 'obedieme', paradigm stays 'e__adv', stem -> 'obediem'
Fixed obezeso: changed lemma to 'obezese', paradigm stays 'e__adv', stem -> 'obezes'
Fixed obstinema: changed lemma to 'obstineme', paradigm stays 'e__adv', stem -> 'obstinem'
Fixed ociema: changed lemma to 'ocieme', paradigm stays 'e__adv', stem -> 'ociem'
Fixed paketo: changed lemma to 'pakete', paradigm stays 'e__adv', stem -> 'paket'
Fixed parolema: changed lemma to 'paroleme', paradigm stays 'e__adv', stem -> 'parolem'
Fixed pasajero: changed lemma to 'pasajere', paradigm stays 'e__adv', stem -> 'pasajer'
Fixed pastureyo: changed lemma to 'pastureye', paradigm stays 'e__adv', stem -> 'pasturey'
Fixed perdero: changed lemma to 'perdere', paradigm stays 'e__adv', stem -> 'perder'
Fixed perfekteso: changed lemma to 'perfektese', paradigm stays 'e__adv', stem -> 'perfektes'
Fixed perpendikleso: changed lemma to 'perpendiklese', paradigm stays 'e__adv', stem -> 'perpendikles'
Fixed perseveremeso: changed lemma to 'perseveremese', paradigm stays 'e__adv', stem -> 'perseveremes'
Fixed peskeyo: changed lemma to 'peskeye', paradigm stays 'e__adv', stem -> 'peskey'
Fixed petulema: changed lemma to 'petuleme', paradigm stays 'e__adv', stem -> 'petulem'
Fixed pianero: changed lemma to 'pianere', paradigm stays 'e__adv', stem -> 'pianer'
Fixed pladeto: changed lemma to 'pladete', paradigm stays 'e__adv', stem -> 'pladet'
Fixed politeso: changed lemma to 'politese', paradigm stays 'e__adv', stem -> 'polites'
Fixed poluteso: changed lemma to 'polutese', paradigm stays 'e__adv', stem -> 'polutes'
Fixed prioreso: changed lemma to 'priorese', paradigm stays 'e__adv', stem -> 'priores'
Fixed profundeso: changed lemma to 'profundese', paradigm stays 'e__adv', stem -> 'profundes'
Fixed purpurea: changed lemma to 'purpuree', paradigm stays 'e__adv', stem -> 'purpure'
Fixed quantesma: changed lemma to 'quantesme', paradigm stays 'e__adv', stem -> 'quantesm'
Fixed quaresma: changed lemma to 'quaresme', paradigm stays 'e__adv', stem -> 'quaresm'
Fixed rafaneto: changed lemma to 'rafanete', paradigm stays 'e__adv', stem -> 'rafanet'
Fixed rafinerio: changed lemma to 'rafinerie', paradigm stays 'e__adv', stem -> 'rafineri'
Fixed rapideso: changed lemma to 'rapidese', paradigm stays 'e__adv', stem -> 'rapides'
Fixed raptero: changed lemma to 'raptere', paradigm stays 'e__adv', stem -> 'rapter'
Fixed rebelesko: changed lemma to 'rebeleske', paradigm stays 'e__adv', stem -> 'rebelesk'
Fixed reciklebla: changed lemma to 'recikleble', paradigm stays 'e__adv', stem -> 'reciklebl'
Fixed reptero: changed lemma to 'reptere', paradigm stays 'e__adv', stem -> 'repter'
Fixed reputeso: changed lemma to 'reputese', paradigm stays 'e__adv', stem -> 'reputes'
Fixed restorerio: changed lemma to 'restorerie', paradigm stays 'e__adv', stem -> 'restoreri'
Fixed ruzema: changed lemma to 'ruzeme', paradigm stays 'e__adv', stem -> 'ruzem'
Fixed sediciema: changed lemma to 'sedicieme', paradigm stays 'e__adv', stem -> 'sediciem'
Fixed segerio: changed lemma to 'segerie', paradigm stays 'e__adv', stem -> 'segeri'
Fixed sekureso: changed lemma to 'sekurese', paradigm stays 'e__adv', stem -> 'sekures'
Fixed sepulteyo: changed lemma to 'sepulteye', paradigm stays 'e__adv', stem -> 'sepultey'
Fixed sigareto: changed lemma to 'sigarete', paradigm stays 'e__adv', stem -> 'sigaret'
Fixed simulero: changed lemma to 'simulere', paradigm stays 'e__adv', stem -> 'simuler'
Fixed singulareso: changed lemma to 'singularese', paradigm stays 'e__adv', stem -> 'singulares'
Fixed skribero: changed lemma to 'skribere', paradigm stays 'e__adv', stem -> 'skriber'
Fixed soleso: changed lemma to 'solese', paradigm stays 'e__adv', stem -> 'soles'
Fixed solidareso: changed lemma to 'solidarese', paradigm stays 'e__adv', stem -> 'solidares'
Fixed solideso: changed lemma to 'solidese', paradigm stays 'e__adv', stem -> 'solides'
Fixed somnambuleso: changed lemma to 'somnambulese', paradigm stays 'e__adv', stem -> 'somnambules'
Fixed sorcero: changed lemma to 'sorcere', paradigm stays 'e__adv', stem -> 'sorcer'
Fixed sordidega: changed lemma to 'sordidege', paradigm stays 'e__adv', stem -> 'sordideg'
Fixed spanego: changed lemma to 'spanege', paradigm stays 'e__adv', stem -> 'spaneg'
Fixed spanieleto: changed lemma to 'spanielete', paradigm stays 'e__adv', stem -> 'spanielet'
Fixed sparebla: changed lemma to 'spareble', paradigm stays 'e__adv', stem -> 'sparebl'
Fixed spionero: changed lemma to 'spionere', paradigm stays 'e__adv', stem -> 'spioner'
Fixed splendideso: changed lemma to 'splendidese', paradigm stays 'e__adv', stem -> 'splendides'
Fixed splinema: changed lemma to 'splineme', paradigm stays 'e__adv', stem -> 'splinem'
Fixed stabileso: changed lemma to 'stabilese', paradigm stays 'e__adv', stem -> 'stabiles'
Fixed sterileso: changed lemma to 'sterilese', paradigm stays 'e__adv', stem -> 'steriles'
Fixed stoneto: changed lemma to 'stonete', paradigm stays 'e__adv', stem -> 'stonet'
Fixed stupideso: changed lemma to 'stupidese', paradigm stays 'e__adv', stem -> 'stupides'
Fixed submiseso: changed lemma to 'submisese', paradigm stays 'e__adv', stem -> 'submises'
Fixed sulketo: changed lemma to 'sulkete', paradigm stays 'e__adv', stem -> 'sulket'
Fixed superbeso: changed lemma to 'superbese', paradigm stays 'e__adv', stem -> 'superbes'
Fixed surveyero: changed lemma to 'surveyere', paradigm stays 'e__adv', stem -> 'surveyer'
Fixed suvereneso: changed lemma to 'suverenese', paradigm stays 'e__adv', stem -> 'suverenes'
Fixed tacema: changed lemma to 'taceme', paradigm stays 'e__adv', stem -> 'tacem'
Fixed tombeyo: changed lemma to 'tombeye', paradigm stays 'e__adv', stem -> 'tombey'
Fixed toxikeso: changed lemma to 'toxikese', paradigm stays 'e__adv', stem -> 'toxikes'
Fixed tranquileso: changed lemma to 'tranquilese', paradigm stays 'e__adv', stem -> 'tranquiles'
Fixed transfigureso: changed lemma to 'transfigurese', paradigm stays 'e__adv', stem -> 'transfigures'
Fixed tristeso: changed lemma to 'tristese', paradigm stays 'e__adv', stem -> 'tristes'
Fixed unanimeso: changed lemma to 'unanimese', paradigm stays 'e__adv', stem -> 'unanimes'
Fixed unesma: changed lemma to 'unesme', paradigm stays 'e__adv', stem -> 'unesm'
Fixed uzero: changed lemma to 'uzere', paradigm stays 'e__adv', stem -> 'uzer'
Fixed vireso: changed lemma to 'virese', paradigm stays 'e__adv', stem -> 'vires'
Fixed viskozeso: changed lemma to 'viskozese', paradigm stays 'e__adv', stem -> 'viskozes'
Fixed vivema: changed lemma to 'viveme', paradigm stays 'e__adv', stem -> 'vivem'
Fixed vizitero: changed lemma to 'vizitere', paradigm stays 'e__adv', stem -> 'viziter'
Fixed volupteso: changed lemma to 'voluptese', paradigm stays 'e__adv', stem -> 'voluptes'
Fixed yuneso: changed lemma to 'yunese', paradigm stays 'e__adv', stem -> 'yunes'
